Title	Description	Sentiment	Category
Taylor Swift Fan Dies at Rio de Janeiro Concert During Heat Wave	"The pop star stopped the show twice to ask the venue to hand out more water, at times taking it upon herself to throw bottles to fans"	3	Dead Fan
Taylor Swift Mourns Fan Who Died Before Rio Concert	"Taylor Swift has been on the international leg of The Eras Tour. On Friday night, she performed in Rio de Janeiro, Brazil at the Nilton Santos stadium. Many fans fell ill due to the heatwave, with a heat index of 140° Fahrenheit, and one concertgoer died of c…"	3	Dead Fan
Taylor Swift Mourns After Death of Her Fan at Brazil Concert	"Taylor Swift is grieving over the death of a concertgoer in Brazil ... saying the tragedy has left her devastated with a ""shattered heart."" The pop star took to Instagram and posted a heartfelt letter after her Friday night ""Eras Tour"" show at…"	3	Dead Fan
Taylor Swift ‘Devastated’ After Fan Dies Before Eras Tour Show in Brazil	"“I can’t believe I’m writing these words but it is with a shattered heart that I say we lost a fan earlier tonight before my show,” Swift wrote in a statement"	3	Dead Fan
"Taylor Swift fan dies at Rio concert as fans complain about high temps, lack of water..."	A 23 year-old Taylor Swift fan has died at the singer’s Eras Tour concert in Rio de Janeiro. The show’s organizers in Brazil said in a statement Saturday morning that Ana Clara Benevides Machado was attended by paramedics during the show and taken to a hospit…	3	Dead Fan
Taylor Swift “Shattered” By Loss Of Fan In Front Row Before Her Concert In Rio	"Taylor Swift has penned an emotional tribute to a young female fan, who died before her Eras show in Rio de Janeiro on Friday evening. On her Instagram account, the solo superstar wrote of her devastation about the loss of the 23-year-old woman – named as Ana…"	3	Dead Fan
Taylor Swift “Devastated” After Fan Dies at Her Brazil Concert	"Taylor Swift is mourning the death of a fan who died at her Eras tour concert in Rio de Janeiro. On Nov. 17, Ana Clara Benevides Machado was rushed to a hospital for treatment after falling ill..."	3	Dead Fan
Fan dies at Taylor Swift show in sweltering Rio de Janeiro	"A young Brazilian fan of U.S. singer Taylor Swift died in Rio de Janeiro on Friday night after falling ill inside the superstar's sweltering concert venue amid a record-breaking heatwave across large swathes of Brazil. Ana Clara Benevides, 23, became unwell a…"	3	Dead Fan
Taylor Swift Fan Dies of Cardiac Arrest After Attending Rio Eras Tour	"Buda Mendes/TAS23 Late Friday night, Taylor Swift made a devastating announcement via her Instagram story: a fan in attendance at the first date of her 3-night Eras Tour engagement in Rio de Janeiro, Brazil had passed away. “I can’t believe I’m writing these…"	3	Dead Fan
Taylor Swift Mourns Fan Who Died Before Brazil Concert	"""I can't believe I'm writing these words but it is with a shattered heart that I say we lost a fan earlier tonight before my show,"" Swift wrote in a handwritten statement Swift's show coincided with a heat wave in Brazil, with Folha reporting that the ""feels-…"	3	Dead Fan
Taylor Swift “Devastated” By Death of Fan at Concert in Rio de Janeiro	"A 23-year-old woman named went into cardiac arrest after attending Swift's ""Eras Tour"" show. Taylor Swift “Devastated” By Death of Fan at Concert in Rio de Janeiro Scoop Harrison"	3	Dead Fan
Fan at Taylor Swift concert dies amid Rio De Janeiro's record-breaking heat wave	A 23-year old student died at the Swift concert as the heat index reached a reported 140 degrees. Fans were not permitted to bring water into the stadium.	3	Dead Fan
Taylor Swift Mourns Fan Who Died Before Brazil Concert	"Taylor Swift has shared a statement mourning a fan who died during the Eras Tour’s stop in Rio de Janeiro, Brazil. The 23-year-old fan reportedly died in a hospital after fainting at the venue amid an extreme heat wave."	3	Dead Fan
“I Feel Overwhelmed by Grief”: Taylor Swift Gives Emotional Tribute to Fallen Fan	"Following the death of a 23-year-old woman during a concert in Brazil, the singer penned a heartfelt message on Instagram."	3	Dead Fan
"Taylor Swift Says A Fan Died Before Her Brazil Concert, Posts Heartfelt Message"	"Taylor Swift is honoring a Swiftie who sadly passed away before her concert. Following the completion of her first Eras Tour performance in Rio de Janeiro, Brazil on Friday (November 17), Taylor posted a message to her Instagram Story acknowledging that a fan…"	3	Dead Fan
Taylor Swift fan dies at Rio concert amid complaints about excessive heat	"Swift posted in her Instagram stories after news of the fan's death writing she has ""a shattered heart."""	3	Dead Fan
'Devastated': Taylor Swift Speaks Out On Fan Who Died Ahead Of Brazil Concert	The singer made the announcement after a Rio de Janeiro show amid a dangerous heat wave in Brazil this week.	3	Dead Fan
Taylor Swift Pens Emotional Message in Wake of Tragic Concert Goer’s Death	Taylor Swift is devastated. She reacts here to the awful and shocking death of a fan who attended a concert in Brazil. Taylor Swift Pens Emotional Message in Wake of Tragic Concert Goer’s Death was originally published on The Hollywood Gossip.	3	Dead Fan
Taylor Swift Releases Statement After Fan Tragically Dies Waiting for Brazil Show	"""I'm not going to be able to speak about this from stage because I feel overwhelmed by grief when I even try to talk about it."""	3	Dead Fan
Taylor Swift Fan Dies From Heat at The Eras Tour in Brazil	"Tonight at The Eras Tour in Brazil, Rio, before Taylor performed, a fan named Ana passed away from heatstroke. It was over 100 degrees and fans were not allowed to bring water into the stadium. Taylor's team passed out water and Taylor herself directed water …"	3	Dead Fan
‘Overwhelmed By Grief’: Taylor Swift Fan Dies Of Cardiac Arrest At Concert	A 23-year-old fan died of cardiac arrest Friday night while attending a Taylor Swift concert in Brazil.	3	Dead Fan
Taylor Swift Is 'Overwhelmed by Grief' After Brazilian Fan Died Pre-Concert	"Taylor Swift spoke out after one of her Brazilian fans died shortly before her Eras Tour concert. “I can’t believe I’m writing these words but it is with a shattered heart that I say we lost a fan earlier tonight before my show,” Swift, 33, wrote via Instagra…"	3	Dead Fan
Taylor Swift fan dies at Rio concert as fans complain about high temperatures and lack of water	"Concert-goers complained they were not allowed to take water into Nilton Santos Olympic Stadium despite soaring temperatures, and federal authorities announced that free water would be made available at all future concerts."	3	Dead Fan
Taylor Swift Mourns Fan Who Died Before Friday Night Brazil Concert: ‘I Feel Overwhelmed by Grief’	"""She was so incredibly beautiful and far too young,"" the singer says in a heartfelt message on Instagram  The post Taylor Swift Mourns Fan Who Died Before Friday Night Brazil Concert: ‘I Feel Overwhelmed by Grief’ appeared first on TheWrap."	3	Dead Fan
Taylor Swift Fan Dies From Cardiac Arrest Shortly After Fainting During Rio Concert in 109 Degree Weather	Taylor Swift stopped the show at one point and pleaded with stadium staff to provide water to concertgoers.	3	Dead Fan
"Fan Dies at Taylor Swift Concert in Rio Amid Heat Complaints, No Water"	"A 23-year-old Taylor Swift fan died at the singer's Eras Tour concert in Rio de Janeiro Friday night, according to a statement from the show's organizers in Brazil. Both fans and politicians reacted to the news with outrage. While a cause of death for Ana C…"	3	Dead Fan
Taylor Swift Mourns Fan Who Died at Brazil Era's Tour Show	"Taylor Swift posted a typed Instagram story--written in her branded 1989 script--about her devastation over the death of a fan at her Era's Tour show in Brazil on Friday. ""I can't believe I'm writing these words but it is with... Read more..."	3	Dead Fan
Taylor Swift ‘Devastated’ After Fan Reportedly Dies of Cardiac Arrest Before Brazil Concert	"The singer shared a heartbreaking message about the concertgoer, who reportedly passed away before she went on stage in Rio de Janeiro."	3	Dead Fan
"Taylor Swift fan dies before show in Brazil, superstar says"	Taylor Swift said Saturday she was devastated by the death of a fan before her show in Brazil on Friday night.	3	Dead Fan
"Taylor Swift Confirms Death Of Fan At ‘Eras Tour’ Show After Hot, Humid Evening Led To Dehydration For Many"	"The record-setting ‘Eras Tour’ has been a source of joy for millions across the United States and in a few international cities as Taylor Swift has shared her chart-topping music with the world. But, tragedy struck on Friday in Rio de Janeiro, Brazil, when a …"	3	Dead Fan
Taylor Swift ‘devastated’ as fan dies ahead of her Brazil concert: ‘Overwhelmed by grief’	"Taylor Swift said she was “overwhelmed by grief” after a fan died ahead of her “Eras Tour” concert in Brazil Friday night. The “Anti-Hero” hitmaker, 33, revealed the tragedy and mourned her fan’s death after she performed the first of three nights at Rio de J…"	3	Dead Fan
Taylor Swift says she has 'shattered heart' after 23-year-old fan dies at Eras Tour concert in Rio de Janeiro	"While the cause of death has not been announced, media reported that fans were not allowed to take water into the stadium despite soaring temperatures."	3	Dead Fan
Taylor Swift says she ‘overwhelmed by grief’ after fan dies while attending Brazil Eras Tour show	"""I can't believe I'm writing these words but it is with a shattered heart that I say we lost a fan earlier tonight before my show,"" she wrote."	3	Dead Fan
Taylor Swift Seems Back to Herself After Tragic Death of Fan in Rio de Janeiro	"Taylor Swift was back to herself during a Friday concert in Brazil after mourning the death of a fan just one week ago. TS hit the stage to perform in front of a packed crowd in São Paulo last evening -- and she appeared to be in great spirits,…"	2	Dead Fan
Police Investigation 'Underway' After Taylor Swift Fan's Death in Brazil	"Brazilian police are taking next steps after the recent death of a Taylor Swift fan. NBC News reported that officials launched an investigation into Time4Fun, the company responsible for organizing Swift’s Eras Tour stops in Rio de Janeiro. Swift, 33, perform…"	3	Dead Fan
"ET ""Confirms"" That Taylor Swift Has Reached Out To Ana Clara Benevides Machado's Family"	"ET has learned that Taylor Swift’s team has reached out to Ana Clara Benevides Machado’s family following her death. pic.twitter.com/aByJh1czJL — Entertainment Tonight (@etnow) November 24, 2023 ET has confirmed that Taylor Swift's team has reached out to A…"	2	Dead Fan
Rio police investigate Taylor Swift concert organizers after fan's death	Rio police investigate Taylor Swift concert organizers after fan's death	3	Dead Fan
How Climate Change Made Taylor Swift's Brazil Concert So Dangerous	The death of a Taylor Swift fan in the midst of a heat wave in Brazil is another sign that we're not doing enough to adapt to a rapidly changing climate.	3	Dead Fan
Taylor Swift’s Rio Concert Venue Has Admitted They Could Have Done More To Keep People Safe In The Extreme Heat	"Ana Clara Benevides, 23, was laid to rest on Tuesday after Swifties crowd-funded the money needed for the family to fly her body home.View Entire Post ›"	3	Dead Fan
The Organizer For Taylor Swift’s Brazilian ‘The Eras Tour’ Dates Is Being Investigated Following A Fan’s Death	"Getty Image Ana Clara Benevides Machado, 23, died on November 17."	3	Dead Fan
News24 | 'Could have taken alternative measures': Brazilian company admit fault after Taylor Swift fan death	The chief executive of the company organising Taylor Swift's tour dates in Brazil apologised after a fan died in a searing heat wave during the superstar's Rio de Janeiro show.	3	Dead Fan
Taylor Swift Brazil Concert Triggers Police Probe After Fan Dies at Stadium	Police in Brazil have reportedly opened a probe into the organizers of last Friday’s oppressively hot Taylor Swift concert that left one fan dead and the pop star gasping for air. A rep for Rio de Janiero’s Civil Police Department said they…	3	Dead Fan
Taylor Swift stops crowd from paying tribute to late fan Ana; Family denies TS or T4F reached out	"Follow-up to this post. Starting on a better note, Ana Clara Benevide's mother thanked everyone who donated money to pay for the body transportation costs, as you can see in the video below: Taylor Swift fans crowdfunded in order to help Ana Benevides’ family…"	3	Dead Fan
Brazil Authorities Investigate Organizer Of Taylor Swift Concert Following Fan's Death	"Ana Clara Benevides, 23, died after falling ill during Friday's concert in Rio de Janeiro, while the city experienced record temperatures."	3	Dead Fan
"Taylor Swift Concert Organizers Under Investigation After Fan, 23, Dies at Singer's Rio De Janeiro Show: Report"	"Taylor Swift fan Ana Clara Benevides Machado passed away on Friday, November 17, at the singer's Rio de Janeiro, Brazil concert due to record high temperatures."	3	Dead Fan
Brazilian officials investigating company behind Taylor Swift shows in Rio de Janeiro after fan's death	SÃO PAULO — Police in Rio de Janeiro said Wednesday that an investigation has been launched into Time4Fun — the Brazilian company that organized Taylor Swift’s shows in the city — days after a fan died and others reported unbearable conditions after attending…	3	Dead Fan
Brazilian officials investigating company behind Taylor Swift shows in Rio de Janeiro after fan's death	Police in Rio de Janeiro said an investigation has been launched into Time4Fun — the Brazilian company that organized Taylor Swift’s shows in the city — days after a fan died at the “Eras Tour” during an extreme heat wave.	3	Dead Fan
Taylor Swift concert organizer apologizes after Rio fan death	The chief executive of the company organizing Taylor Swift's tour dates in Brazil apologized Thursday after a fan died in a searing heat wave during the pop superstar's Rio de Janeiro show. Organizers have faced criticism after fans said they were forbidden t…	3	Dead Fan
Police in Brazil launch investigation after Taylor Swift fan dies at concert	"“Event organizers will be called to testify, and other steps are underway to investigate the facts,” a rep for the Civil Police Department in Brazil told NBC News."	3	Dead Fan
Brazilian officials investigating company behind Taylor Swift shows in Rio de Janeiro after fan’s death	Police in Rio de Janeiro said Nov. 22 that an investigation has been launched into Time4Fun — the Brazilian company that organized Taylor Swift’s shows in the city — days after a fan died and others reported unbearable conditions after attending the “Eras Tou…	3	Dead Fan
Family of Taylor Swift fan who died at Rio concert attends singer’s third Eras Tour show in São Paolo	"Ana Clara Benevides died ahead of Swift's show on Nov. 17 after going into cardiac arrest amid extreme temperatures in Rio de Janeiro, Brazil."	2	Dead Fan
Swifties Raise Money For Family Of Fan Who Died At Taylor Swift Concert	"Ana Clara Benevides died after attending the singer's show in Rio de Janeiro, Brazil."	1	Dead Fan
Swifties raise money for family of fan who died at Brazil Eras Tour stop	"Taylor Swift fans in Brazil have helped raise money to transport the body of Ana Clara Benevides Machado, who died at Swift’s concert on November 17, from Rio de Janeiro to the Brazilian state of Mato Grosso do Sul. A fan posted a video, reportedly from Benev…"	1	Dead Fan
Extreme heat led to a Taylor Swift fan’s death in Brazil. Could it have been prevented?	"In an era of rising heat waves, experts weigh in on how to plan for concerts and other large events safely."	3	Dead Fan
Taylor Swift gifts VIP experience to family of fan who died at her Brazil concert	"The family of Ana Clara Benevides, a Taylor Swift fan who died at her Rio de Janeiro concert earlier this month, were treated to a VIP experience of the popstar&apos;s Sao Paulo sh"	1	Dead Fan
Death at Taylor Swift concert: How event organizers deal with heat	"After the death of a 23-year-old woman in Brazil, DW looks at how organizers of large events handle extreme heat and supply water."	3	Dead Fan
Mom of Taylor Swift fan who died at Brazil concert gets emotional over Swifties’ help to return daughter’s body after blasting show organizers	"Ana Clara Benevides, 23, died after becoming ill at Swift's Friday concert in Rio."	2	Dead Fan
The Slatest for Nov. 21: Trump’s Lawyers Argued He Might Be Able to Reveal the Names and Addresses of Jurors	"Stories about a fan's death at a Taylor Swift show, the Supreme Court and the Voting Rights Act, the secret to perfect mashed potatoes, and more."	3	Dead Fan
Two fans have died following Taylor Swift's trio of shows in Rio de Janeiro	"Taylor Swift is currently on the South American leg of The Eras Tour. Three consecutive dates at Estádio Nilton Santos in Rio de Janeiro, Brazil have been marred by intense heat and pickpocketing."	3	Dead Fan
A Fan Died at a Taylor Swift Show. Then It All Got Very Confusing.	The heat was blazing. The floor was metal. Was there anything else she could have done?	3	Dead Fan
Taylor Swift fan dies at Rio de Janeiro leg of Eras Tour	23-year-old Ana Clara Benevides died of caridac arrest while attending a Taylor Swift show at Rio's Nilton Santos stadium on November 17. Swift postponed the following night's show amid safety concerns as record heats were recorded in the Brazilian city.	3	Dead Fan
Taylor Swift Debuts Grief-Stricken Ballad Live After Fan’s Death	"TAS2023 Via Getty Images Taylor Swift got back to business on Sunday, resuming her Eras Tour in Rio de Janeiro, Brazil, after a succession of disasters and delays. On Friday night, a Swift fan passed away at a local hospital after falling ill at Nilton Santo…"	3	Dead Fan
Taylor Swift Gets Emotional After Returning to Stage in Brazil Amid Fan’s Death	Taylor Swift returned to the stage in Brazil after a hiatus due to the sizzling heat -- and seemingly paid tribute to a fan who recently died at one of her shows. The pop superstar put on an emotional performance Sunday at Estadio Nilton Santos…	3	Dead Fan
Father of Taylor Swift Fan Who Died at Her Brazil Show Speaks Out	"The father of Ana Clara Benevides Machado, the Taylor Swift fan who tragically died at the singer’s concert in Brazil, is speaking out. The 23-year-old young woman died ahead of the Eras Tour show at the Estadio Nilton Santos last Friday (November 17) in Rio …"	3	Dead Fan
Taylor Swift Performs Grief Ballad “Bigger Than the Whole Sky” Days After Concert Death Of Fan Ana Clara Benevides Machado	"At her Rio de Janeiro concert Sunday night, Taylor Swift performed a deep album cut about grief, “Bigger Than the Whole Sky,” just two days after the tragic death of fan Ana Clara Benevides Machado. The 23-year-old Benevides Machado died Friday after falling …"	3	Dead Fan
Taylor Swift postpones Brazil Eras tour following death of fan	"Taylor Swift began the South American leg of her Eras Tour last weekend in Argentina. The next day, Travis Kelce flew down to see her and Taylor ended up rain-checking that night’s show due to, well, rain. She said on Twitter “I love a rain show but I’m never…"	2	Dead Fan
Taylor Swift Appears to Honor Late Fan With Emotional Surprise Song Choice	"Taylor Swift appeared to pay tribute to late fan Ana Clara Benevides Machado with an emotional song choice on night two in Brazil. At every show on her Eras tour, Swift, 33, performs two surprise songs acoustically and on Sunday, November, 19, Swift opted to …"	1	Dead Fan
Taylor Swift Returns to the Stage With Moving Tribute After Fan Died	"Taylor Swift shared a tearful moment with the crowd at her latest concert. The Grammy winner returned to the stage in Rio de Janeiro on Nov. 19, where she performed ""Bigger Than the Whole Sky"" as..."	2	Dead Fan
Taylor Swift Gives Tearful Performance in Tribute to Deceased Fan Ana Clara Benevides	"Swift delivered an emotional rendition of ""Bigger Than the Whole Sky.""  Taylor Swift Gives Tearful Performance in Tribute to Deceased Fan Ana Clara Benevides Scoop Harrison"	2	Dead Fan
Family of Taylor Swift Fan Who Died After Brazil Concert Calls for Investigation	"“I feel this loss deeply and my heart goes out to her family and friends,” Taylor Swift said in a handwritten statement."	3	Dead Fan
Rain-Soaked Taylor Swift Performs Emotional ‘Bigger Than The Whole Sky’ in Honor of Dead Fan	"Last week was a tough one for Taylor Swift. Dangerously high temperatures in Brazil are thought to be the cause of the tragic death of 23-year-old Ana Clara Benevides Machado, who was tended to by paramedics at an Eras Tour... Read more..."	1	Dead Fan
Taylor Swift Postpones Rio Concert Amid Safety Concerns Following Fan’s Death	"Taylor Swift took to social media on Saturday evening to announce that she was postponing her concert, amid concerns over safety."	3	Dead Fan
"Taylor Swift postpones Brazil show due to heat, day after fan dies during concert"	"Taylor Swift postponed an Eras Tour concert in Rio de Janeiro Saturday after a 23-year-old fan died during her Friday night show, according to a message posted on the singer's Instagram."	3	Dead Fan
"Taylor Swift postpones Brazil concert after fan dies amidst ""extreme temperatures"""	"Taylor Swift has announced that she’s postponing a concert scheduled for tonight in Rio de Janeiro, after a fan died after attending her concert on Friday night in the city. Rio is currently experiencing record heat waves that have generated a heat index (i.e…"	3	Dead Fan
"Taylor Swift postpones Rio show over ""extreme weather"" after fan's death"	"Taylor Swift postponed a concert in Rio de Janeiro, Brazil, after a 23-year-old fan died during the Friday night show of Swift's Eras Tour."	3	Dead Fan
Father of Taylor Swift Fan Pays Tribute After Daughter Died at 'Eras Tour'	"The father of Ana Clara Benevides Machado, the Taylor Swift fan who died before the debut Eras Tour concert in Brazil, has broken his silence on her death. “I lost my only daughter, a happy and intelligent girl,” Weiny Machado told local newspaper Folha de Sã…"	2	Dead Fan
"Taylor Swift postpones second night in Rio, 2 hours before show, following death of fan"	Taylor Swift on Saturday postponed the second night of her Eras Tour in Brazil citing the scorching heat that has stifled most of the South American country in the past few days. Swift’s decision — which was announced approximately two hours before her show w…	3	Dead Fan
Taylor Swift Postpones Saturday Show in Rio In Wake Of Fan Death	"Taylor Swift has postponed her Saturday night concert in Rio de Janeiro because of extreme temperatures in the city. The move comes a day after a fan died at her first Eras Tour show in the city. “The safety and well-being of my fans, fellow performers, and c…"	3	Dead Fan
"Taylor Swift Postpones 2nd Brazil Show Amid Fan Death, Scorching Heat"	"Taylor Swift is postponing her second show in Brazil this weekend after a fan died the day prior and amid scorching temperatures there in the city that she deems too dangerous. The pop star announced the decision Saturday, not long before she was…"	3	Dead Fan
"Swift postpones Rio concerts, 'devastated' by fan's death"	"During a Taylor Swift show in Rio de Janeiro, a fan fell ill in the sweltering heat and later died. The pop star has said she postponed an Eras Tour show due to the extremely high temperature."	3	Dead Fan
"See Taylor Swift Debut ‘Suburban Legends,’ Unearth ‘Stay Beautiful’ at Rio Show"	"Taylor Swift dug out another pair of deep cuts in Rio De Janeiro Friday as the singer performed ""Suburban Legends"" and ""Stay Beautiful."""	2	Eras Tour
Brasil Welcomes Taylor Swift with Projection on Christ the Redeemer	"Rio de Janeiro's mayor said that the city would ""properly honor"" Swift with the projection, and compared her to Michael Jackson. Brasil Welcomes Taylor Swift with Projection on Christ the Redeemer Jo Vito"	1	Eras Tour
Christ the Redeemer welcomes Taylor Swift to Rio as Philly 'punts' her for Eagles-Chiefs game	Taylor Swift fans lit up Brazil's Christ the Redeemer statue Thursday. But the City of Brotherly Love doesn't share the sentiment ahead of Eagles-Chiefs game.	2	Eras Tour
"Taylor Swift Reacts to Being Honored on Brazil's Christ the Redeemer Statue, Credits Her Fans!"	"Taylor Swift is reacting to the warm welcome she received by Brazil this week! The 33-year-old entertainer kicked off her run of shows at Estádio Olímpico Nilton Santos in Rio de Janeiro, Brazil on Friday night (November 17) and she thanked fans for the speci…"	1	Eras Tour
"Taylor Swift Goes to Brazil, Swiftie Says It's Time People Accept She's MJ Level Famous"	"she is actually michael jackson level of famous and yall need to finally accept it https://t.co/ftnaUGlp0N — thanos. (@THANOSNOVA) November 17, 2023 Taylor Swift took her Eras Tour to Brazil.The world's most famous statue of Jesus Christ, the Christ the Red…"	2	Eras Tour
Airline Waived Flight-Change Fees Thanks to Taylor Swift	"Occasionally, an airline will do the right thing, even if it means they lose significant money in the process. The good news is that such a circumstance happened just last…"	1	Eras Tour
Brazil's Christ the Redeemer statue welcomes Taylor Swift with unique display	Taylor Swift and the Eras Tour will receive a special welcome to Rio de Janeiro on Thursday night with a projection on the city's iconic Christ the Redeemer.	1	Eras Tour
Taylor Swift Reacts to Junior Jewels T-Shirt Projection Onto Christ the Redeemer Statue: ‘There’s No Way That’s Real’ | Video	"“That has to be photoshopped,"" the songstress says The post Taylor Swift Reacts to Junior Jewels T-Shirt Projection Onto Christ the Redeemer Statue: ‘There’s No Way That’s Real’ | Video appeared first on TheWrap."	2	Eras Tour
Taylor Swift Honored in Brazil With Projection on Christ the Redeemer Statue: Photo	The Grammy winner is closing out the month with a handful of tour dates in Brazil and the country just greeted Taylor in the best way possible!	1	Eras Tour
Taylor Swift Saved Public Transport And Now She's Fixing Airlines Too	Airlines will usually stop at nothing to squeeze every penny from you when you book to fly with them. But there’s one person who can force their hand and encourage them to scrap change fees for passengers: Ms. Taylor Alison Swift.Read more...	1	Eras Tour
Taylor Swift Played “Is It Over Now?” And Sang About Travis Kelce In Buenos Aires	"Taylor Swift kicked off the South American leg of her Eras Tour this week, and at her first show in Buenos Aires, she played “The Very First Night” and “Labyrinth” live for the first time. That was on Thursday; Friday night’s show was rescheduled for Sunday d…"	2	Eras Tour
Taylor Swift Performs “Slut!” For The First Time And Tells Fans Not To Throw Things Onstage	"It’s been an eventful trip to Argentina for Taylor Swift. Thursday, at the first South American date of her Eras Tour, she played “The Very First Time” from Red (Taylor’s Version) and “Labyrinth” from Midnights live for the first time. Friday, her second Buen…"	2	Eras Tour
Taylor Swift reveals the fan behavior that freaks her out	"During her Buenos Aires concert on Sunday night, Taylor Swift asked fans to stop throwing things on stage, saying ""it really freaks me out."" During the ""Evermore"" part of her Eras Tour set, Swift paused to calmly, but firmly, address the crowd after a present…"	2	Eras Tour
Taylor Swift Asks Audience To Hold The Gifts: “It Really Freaks Me Out When Stuff Gets Thrown On The Stage”	"Taylor Swift likes gifts, just not on stage. During a concert in Buenos Aires, Argentina, Swift briefly interrupted her show when, seated at the piano, she politely asked fans not to throw things on the stage. “Just because communication means having gentle, …"	2	Eras Tour
Why A Major Airline Waived Fees Just For Taylor Swift Fans	"Soon after Taylor Swift postponed her Buenos Aires concert, South America’s largest airline offered Swifties a lifeline."	1	Eras Tour
Taylor Swift Is ‘Never Beating the Sorcery Allegations’ After Perfectly Timed Eras Tour Moment	"Taylor Swift is proving time and time again that she’s the ultimate “Mastermind.” The pop superstar took to Twitter to share a hilarious video from her Eras tour stop in Buenos Aires, Argentina, this weekend, in which she’s seen singing “Labyrinth” off her 20…"	1	Eras Tour
Taylor Swift Adds Two More Summer 2024 London Eras Tour Dates With Paramore	Taylor Swift is giving her UK fans two more chances to get in on the Eras Tour action. The singer announced on Monday (Nov. 13) that she will be adding a pair of gigs in London to her stint at London’s Wembley Arena next summer. Related Taylor Swift Is ‘Never…	2	Eras Tour
Taylor Swift Scolds Concertgoers for Throwing Things on Stage in Buenos Aires: ‘It Really Freaks Me Out’	"Taylor Swift is reminding fans to not throw things onto the stage at her shows. At least one object made its way toward Swift in Buenos Aires, Argentina, Sunday night (Nov. 12) while she was performing at Estadio River Plate for the Eras Tour concert that had…"	2	Eras Tour
Taylor Swift asks fans not to throw things on stage: “It really freaks me out”	Taylor Swift became the latest artist to request that fans don't throw things on to the stage during live shows.	2	Eras Tour
Taylor Swift Surprises Fans With 2 Songs Believed to Be About Harry Styles During 'Eras Tour'	"Taylor Swift‘s Eras Tour Surprise Songs had fans thinking about Harry Styles on Saturday night (November 10) in Buenos Aires, Argentina. The 33-year-old pop titan took the stage at Estadio River Plate for her second performance since resuming the tour earlier…"	2	Eras Tour
"Taylor Swift 'Wasn't Too Happy' About Postponing 'Eras' Tour Stop in Buenos Aires, Travis Kelce Reveals"	"Travis Kelce is revealing Taylor Swift‘s reaction to having to postpone one of her Eras tour shows in Buenos Aires, Argentina. On Friday (November 10), the 33-year-old superstar was forced to postpone her show due to weather. It was rescheduled for that Sunda…"	2	Eras Tour
"Taylor Swift Left Argentina So Quickly, She Was Still Wearing Her 'Eras Tour' Costume!"	Taylor Swift walked off the stage after the final show of The Eras Tour in Argentina and left the country so quickly that she was still wearing her costume from the concert! New photos have emerged showing Taylor still in her Midnights outfit while boarding a…	2	Eras Tour
Taylor Swift asks fans not to throw things on stage	"️| Taylor very kindly asking the crowd to not to throw things on stage  #BuenosAiresTSTheErasTour ""And just because communication means having gentle healthy boundaries - it really freaks me out when stuff gets thrown on the stage. Because if it's on the …"	2	Eras Tour
Campaign fundraisers are hitting high notes at Taylor Swift and Beyoncé concerts	"Congressional candidates are getting creative, and having fun, as they raise cash (Taylor’s Version)."	2	Eras Tour
Watch Taylor Swift Play “The Very First Night” And “Labyrinth” Live For The First Time In Buenos Aires	"Taylor Swift’s Eras Tour has gone worldwide. Tonight, she kicked off the international leg of her tour in Buenos Aires, Argentina at the Estadio Monumental, where fans have been camping out since June, according to Pitchfork. Lucky for them, the pop star gave…"	2	Eras Tour
Taylor Swift Postpones Buenos Aires Concert As “Truly Chaotic” Weather Hits City	"Taylor Swift has postponed tonight’s Eras Tour concert in Buenos Aires due to what she called “truly chaotic” weather, a description that might also apply to the media frenzy with the arrival in Argentina last night of Travis Kelce. The Kansas City Chiefs tig…"	2	Eras Tour
How ‘The Marvels’ Can Benefit From ‘Taylor Swift: The Eras Tour’ Boost	Can a super-team-up between Taylor Swift and The Marvels bring audiences together so both films top the weekend box office charts?	2	Eras Tour
"AMC's Earnings Will Feature Barbie and Oppenheimer. Maybe Taylor Swift, and Beyoncé, Too"	"AMC Entertainment's results, set to be released after tonight's closing bell, will be all about this summer's blockbuster movie phenomenon known as Barbenheimer. AMC stock is down 71% so far this year and fell more than 6% on Tuesday.#amcentertainment #barben…"	2	Eras Tour
"Taylor Swift, Beyonce Headline The List Of Top-Grossing Summer Tours 2023 | Forbes"	"Enthusiastic music fans had a summer filled with A-liners hitting the stage all around the world.  P!ink was the first woman to headline a tour in Wisconsin, Taylor Swift walked her Runway in over 50 shows throughout the United States."	1	Eras Tour
There's one thing Taylor Swift isn't talking about	Taylor Swift is a billionaire after her Eras Tour and movie boosted her 2023 net worth. The pop star's brand benefits from her downplaying her wealth.	2	Eras Tour
Get Your Parkas Ready For December 2024 – Canadian Swifties Haven't Been Able To Focus Since Taylor Swift JUST Announced Three New Concert Dates	Step 1) Register for Verified Fan Presale on Ticketmaster. Step 2) Look at flights to Vancouver.View Entire Post ›	2	Eras Tour
Taylor Swift Adds 2024 Vancouver Dates To Eras Tour	"Vancouver Swifties will have an extra something to celebrate next holiday season: Taylor Swift has added three dates in the city to the 2024 leg of her Eras Tour. The new dates are Dec. 6, 7 and 8, 2024, at B.C. Place in Vancouver, British Columbia. Gracie Ab…"	2	Eras Tour
What Lina Khan Could Learn About Amazon From Taylor Swift	"Like Swift, Amazon used to look up. The answer to Khan’s senseless lawsuit can be found in this truth."	1	Eras Tour
Your Favorite Filmmakers Line Up to Praise Taylor Swift	"Not sure if you've heard, but Taylor Swift is coming off one of the most successful tours of all time, and has a movie in theaters that's doing gangbusters right now. We covered how Taylor Swift got her exclusive deal with AMC, and now many famous filmmakers …"	1	Eras Tour
Taylor Swift has Illuminati money now	"Taylor Swift is officially a billionaire now, and her Eras Tour has added an estimated $4.3 billion to the U.S. gross domestic product this year"	2	Eras Tour
"Everything Celebrities Have Said About Taylor Swift's 'Eras Tour', Including Olivia Rodrigo & Travis Kelce's Comments"	"Celebrities have a lot to say about Taylor Swift‘s Eras Tour! Since Taylor kicked off her massive tour on March 17, 2023 in Arizona, the biggest stars in music, movies, TV, and even sports have enjoyed their amazing views from VIP tents across the country and…"	2	Eras Tour
Taylor Swift Performs ‘Safe & Sound’ and ‘Untouchable’ Live for the First Time in Over a Decade in Sao Paulo	"Taylor Swift surprised fans with two rarely performed songs at her Saturday night concert at the Allianz Parque stadium in São Paulo, Brazil, on Nov. 25. “This has been a tradition that I started on The Eras Tour,” Swift said to the São Paulo crowd, explainin…"	2	Eras Tour
"Taylor Swift Performs ‘Safe & Sound,’ ‘Untouchable’ Live in Sao Paulo"	"“Both songs I am playing tonight I have never, ever played on this tour,” Swift said of the acoustic set list at the Allianz Parque stadium."	2	Eras Tour
Watch Taylor Swift Perform “Now That We Don’t Talk” Live For The First Time In São Paulo	"While on the South American leg of her Eras Tour, Taylor Swift has slowly been giving live debuts to the vault tracks of her most recent release, 1989 (Taylor’s Version). At concerts in Buenos Aires, the pop star performed “Is It Over Now?,” “Slut,” and “Subu…"	2	Eras Tour
Billy Joel Dishes on Taylor Swift & Taking His Daughters to the 'Eras Tour'	"Billy Joel is opening up about his experience at Taylor Swift‘s Eras Tour! While chatting with People at the Long Island Music and Entertainment Hall of Fame on Friday (November 24), the 74-year-old “Piano Man” singer shared his opinion on Taylor and her mass…"	2	Eras Tour
"Tour news: Taylor Swift, Jerry Seinfeld, The Dwarves, Screaming Females, and more"	"Here’s a roundup of recent tour news. Check the Tour Dates category for more. TAYLOR SWIFT Taylor Swift continues to expand The Eras Tour, having added three new Vancouver shows in December 2024. Will this tour ever end? Swifties hope not. All dates are here.…"	2	Eras Tour
Billy Joel Says He Scored ‘Cool Dad Points’ After Taking Daughters to Taylor Swift’s Eras Tour	"Billy Joel earned “very cool dad points” after taking his daughters to see Taylor Swift in concert. The Piano Man opened up during an interview with People about attending the pop superstar’s Eras Tour in Tampa, Fla., on March 15 with his little pair of Swift…"	1	Eras Tour
Taylor Swift appears in good spirits at Brazil show one week after ‘traumatic’ death of fan	The pop superstar took the stage at São Paulo's Allianz Parque stadium and commended her fans for breaking the venue's attendance record.	2	Eras Tour
See Taylor Swift Debut ‘Now That We Don’t Talk’ Live in São Paulo	"Taylor Swift’s The Eras Tour continued Friday in São Paulo, Brazil, where the singer performed a pair of deep cuts in the Surprise Songs segment."	2	Eras Tour
Taylor Swift Dazzles on Stage in Brazil 1 Week After Fan’s Tragic Death	The “Bejeweled” singer put on an incredible show in São Paulo while still mourning the death of a fan at her Rio concert.	1	Eras Tour
Rio police investigate Taylor Swift concert organizers after fan's death	"A couple protect themselves with an umbrella for high temperatures, as they wait before the Taylor Swift concert, following the death of a fan due to the heat during the first day concert, in Rio de Janeiro, Brazil, November 18, 2023. REUTERS/Pilar Olivares/F…"	3	Eras Tour
Taylor Swift Debuts ‘Now That We Don’t Talk’ Live in Sao Paulo	"Taylor Swift debuted “Now That We Don’t Talk” live at her first concert in São Paulo, Brazil, Friday night (Nov. 24). Swift surprised fans at the city’s Allianz Parque stadium with the 1989 (Taylor’s Version) vault track on acoustic guitar. “I’ve never perfor…"	2	Eras Tour
Taylor Swift's hat giveaway leaves lasting impression as Eras Tour 2023 wraps up in Brazil	"As the final notes of Taylor Swift&apos;s 2023 leg of her Eras Tour is wrapping off this weekend at the Allianz Parque stadium in Sao Paulo, Brazil, fans are left wanting more, not"	2	Eras Tour
"Concert Chaos: Taylor Swift screams at security, Miranda Lambert skewers, and Adele issues warnings"	"In recent months, concert venues have witnessed a surge in dramatic incidents, from fan altercations to artists halting performances due to security concerns. Renowned figures like Taylor Swift, Miranda Lambert, and Adele have encountered unexpected disruptio…"	3	Eras Tour
Taylor Swift Debuts ‘Now That We Don’t Talk’ And Brings Back A ‘Speak Now’ Fan-Favorite In Sao Paulo	Getty Image She hadn't played the 'Speak Now' selection since the 2010 Video Music Awards.	2	Eras Tour
Taylor Swift overcomes fan death and dazzles at her Sao Paulo concert	"Taylor Swift returned to the stage in Sao Paulo, Brazil, just a week after the death of a fan during her Rio de Janeiro concert. The pop superstar, dressed in a glittering silver a"	1	Eras Tour
Taylor Swift's São Paulo concert shatters records with largest-ever crowd - Hindustan Times	Taylor Swift's São Paulo concert shatters records with largest-ever crowdHindustan Times Taylor Swift Seems Back to Herself After Tragic Death of Fan in Rio de JaneiroTMZ Tragedy hit Taylor Swift's 'Eras Tour' | WION E-ClubWION A Taylor Swift Fan Has Given A …	1	Eras Tour
Taylor Swift Debuts ‘Now That We Don’t Talk’ in Sao Paulo on Eras Tour	"“I’ve never performed this one live before. Let’s see how I do with it,” she said at Allianz Parque, where she also played “Innocent” live for the first time in …"	2	Eras Tour
Billy Joel 'Got Cool Dad Points' for Taking Kids to See Taylor Swift (Exclusive)	"In an exclusive conversation with PEOPLE, Billy Joel opens up about how he and his wife, Alexis Roderick, took their two daughters, Della Rose, 8, and Remy Anne, 6, to see — and meet — Taylor Swift during her Eras Tour stop in Tampa, Florida, in April."	1	Eras Tour
"Taylor Swift scolds security guard, Miranda Lambert skewers fans as concerts go off the rails"	There seems to be a lot of drama at concerts lately – including performers like Taylor Swift getting upset with a security guard and Shania Twain taking a tumble.	3	Eras Tour
When Is Taylor Swift: The Eras Tour Movie Leaving Theaters & Cinemas?	"Hitting the theaters on October 13, 2023, the Taylor Swift: The Eras Tour movie has performed extremely well at the domestic and worldwide box office. But, soaring past its fourth weekend, many fans across the world are wondering when the Eras tour will leave…"	2	Eras Tour
Billy Joel Opens Up About Taking Daughters to Taylor Swift’s Eras Tour	Billy Joel Opens Up About Taking Daughters to Taylor Swift’s Eras Tourbillboard.com	2	Eras Tour
Fans are still waiting for Ticketet's systems to open	"About 3 months before the Australian leg of Taylor Swift's Eras Tour, Swifties are not smiling again because Ticketek Marketplace not working at the moment. Ticketek, a well-established Australian ticket provider, was […] Thank you for being a Ghacks reader. …"	2	Eras Tour
I'm a Swiftie Dad who traded a family summer vacation to take my kids across the country to an Eras Tour concert. It was worth every penny	"The author has no regrets about nixing a typical family summer vacation for a Taylor Swift concert. Kevin Winter/TAS23/Getty Images for TAS Rights Management; Cork Gaines/Business Insider We had already been to one Taylor Swift concert, but we wanted to try f…"	1	Eras Tour
Ticket prices to see Taylor Swift in Brazil are dropping	Some tickets are already $100 cheaper than they were just four days ago.	2	Eras Tour
Neuroscience Just Explained Why Taylor Swift's Eras Tour Is So Memorable. It Can Work for You Too	The right music can help you make sure important information gets remembered.	1	Eras Tour
Taylor Swift Announces “The Eras Tour” Shows in Vancouver	"""The Eras Tour"" comes to BC Place in December 2024. Taylor Swift Announces “The Eras Tour” Shows in Vancouver Scoop Harrison"	2	Eras Tour
‘Five Nights at Freddy’s’ Beats Opening Weekend Ticket Sales for ‘Oppenheimer’ and ‘Taylor Swift: The Eras Tour’	"""The Holdovers"" and ""Priscilla"" both show initial promise in platform debuts, but with $78 million ""Freddy's"" is an ""Easy Rider"" moment for Gen Z."	2	Eras Tour
How Should We Measure Success For Musician’s World Tours?	How Should We Measure Success For Musician’s World Tours? Many of the leading music headlines this past summer have had to do with touring. Whether it’s Taylor’s legendary run with the Eras Tour or Sheeran’s monstrous attendance records at the Melbourne Crick…	1	Eras Tour
"AMC Entertainment Will Lean Into Concert Films After ‘Eras Tour’ Success; “Our Phone Has Been Ringing Off The Hook,” Says CEO"	"Theater chain AMC will make a handsome profit from distributing Taylor Swift: The Eras Tour and from its box office grosses, which passed $232 million globally, said CEO Adam Aron. He declined to give any numbers until year end since both Swift — and Renaissa…"	2	Eras Tour
Is Taylor Swift’s ‘Eras Tour’ Concert Movie Coming To Streaming Soon?	"Since its theatrical release, the 'Eras Tour' film has been busy breaking box office records. Here's when Swifties may be able to stream the concert movie at home."	2	Eras Tour
"Eras Tour choreographer spills on Taylor Swift's favorite routines and her ""great guy"", Travis Kelce"	"If you ever wondered about Taylor Swift&apos;s favorite dance routines during her Eras Tour, you&apos;re in for a treat! The tour&apos;s choreographer, Mandy Moore, spilled the bea"	2	Eras Tour
Taylor Swift's Concert Film Dominates The Box Office On Opening Weekend	"Hugh McIntyre, a Forbes contributor, joins ‘Forbes Newsroom’ to discuss Taylor Swift’s new concert film Taylor Swift: The Eras Tour being number one in the box office on opening weekend."	1	Eras Tour
The movies are back. But we're still learning how to love going to theaters again	"From 'Barbenheimer' to 'Taylor Swift: The Eras Tour,' people are going to cinemas again. But a post-pandemic, post-strike Hollywood has its work cut out for it."	2	Eras Tour
"Taylor Swift’s choreographer spills the tea on singer’s fave Eras Tour routine, ‘great guy’ Travis Kelce"	"“She really loves ‘Vigilante [S–t],’ like, she really loves that one!” the Emmy Award-winning choreographer told Page Six of the sexy dance number."	2	Eras Tour
25 Famous Couples Who Called It Quits in 2023	"Many have dubbed 2023 the year of breakups. Some attribute all the splits to the powerful feminist messages coming from Barbie, the Eras Tour, and ... Read More"	2	Eras Tour
The IRS Won't Make Taxpayers Report Taylor Swift Ticket Sales (and Other Online Transactions Over $600)	The IRS will once again postpone enforcement of a new provision in the tax code that requires online sellers to report as little as $600 in annual income.	2	Eras Tour
A Brazilian Swiftie Went Home With the Heel From Taylor Swift’s Bejeweled Louboutin Boots	"Taylor Swift broke her heel during the 'Lover' segment of her Eras tour show in Rio De Janeiro, Brazil."	2	Eras Tour
Taylor Swift Shakes Off Eras Tour Wardrobe Malfunction	"If the shoe fits, walk in it 'til your high heels break. Taylor Swift did just that during the Nov. 20 stop of her Eras Tour in Rio de Janeiro. While performing songs from her Lover era to the..."	2	Eras Tour
Why Taylor Swift Is Missing the Chiefs vs. Eagles Game	Taylor Swift is rooting for her football hero from afar. The pop superstar originally planned to jet out from Brazil during a break on her sold-out Eras Tour to catch Travis Kelce's Kansas City...	2	Eras Tour
Taylor Swift Compared to 'Barbie' After Heel Mishap at Brazil Show	"Taylor Swift is a real-life Barbie doll, straight from the big screen, 'cause she mimicked something Margot Robbie did in the film ... and, for a moment, she had all eyes on her heels and feet. The singer was performing Monday night in Rio de…"	2	Eras Tour
What's behind the extreme heat wave in Brazil that forced Taylor Swift to postpone a show	"Thousands of Taylor Swift's fans in Brazil have braved extreme heat to watch the singer perform on her wildly popular ""Eras Tour."""	2	Eras Tour
"Taylor Swift's Heel Breaks at Final Rio Show, 'Barbie' Comparisons Are Made By Fans"	Taylor Swift performed her final of three Eras Tour concerts in Rio on Monday night (November 20) and she suffered a wardrobe malfunction at the top of the show. The 33-year-old singer was performing the Lover era when the heel of her right boot unfortunately…	2	Eras Tour
Taylor Swift pulls ‘Barbie’ move after breaking heel during third Brazil Eras Tour concert	"A video showed the singer ripping the heel off her bejeweled Christian Louboutin boot and tossing it into the crowd before continuing her ""Lover"" set."	2	Eras Tour
Taylor Swift Is Her Own Support System After Onstage Wardrobe Malfunction	Barbie could never with that arch.	2	Eras Tour
"Taylor Swift’s Rio tour marred by deaths, muggings, and a dangerous heat wave"	Legions of Taylor Swift’s Brazilian fans were left angry and disappointed in the three-day Rio de Janeiro leg of the pop superstar’s Eras Tour.	3	Eras Tour
"Netflix Is Removing 38 Titles in December 2023, Including a Taylor Swift Tour Movie & 'Love Actually'"	"Netflix has just released the full list of movies and television shows being removed from the streaming service in December 2023. This list includes lots of fan favorite titles from actors like Tom Cruise and Leonardo DiCaprio. In fact, all of Tom‘s Mission: …"	2	Eras Tour
Taylor Swift Handles A Wardrobe Malfunction Like A Champ	"She continued to walk on tiptoe for quite some time, mimicking the height the heel would have been"	1	Eras Tour
Watch Taylor Swift Debut ‘Bigger Than the Whole Sky’ in Rio	Taylor Swift live debuted ‘Bigger Than the Whole Sky’ at her Eras Tour concert in Rio de Janeiro on Sunday night.	2	Eras Tour
The Taylor Swift Info War	"Over the weekend, Taylor Swift played a long-awaited string of concerts in Brazil. And it was, by all accounts, a disaster."	3	Eras Tour
Live Nation/Ticketmaster Subpoenaed By Senate Subcommittee Investigating Hefty Prices For Taylor Swift And Other Concerts	"A Senate subcommittee has subpoenaed Live Nation/Ticketmaster, demanding documents as part of an investigation into exorbitant ticket prices for Taylor Swift, Bruce Springsteen and other concerts. Sen. Richard Blumenthal (D-CT), who chairs the Permanent Subco…"	2	Eras Tour
Taylor Swift Appears to Have a Hard Time Breathing at Brazil Show in New TikTok Video	"Swifties are concerned about Taylor Swift! In a video from her Friday (November 17) Eras Tour concert in Rio de Janeiro, Brazil, it looks like the 33-year-old singer is having a hard time breathing. The “Anti-Hero” singer performed through extreme heat. Keep …"	3	Eras Tour
Taylor Swift Seemingly Struggles to Breathe During Brazil Concert	"Taylor Swift was seemingly gasping for air during her sweltering hot concert in Brazil, freaking out some of her fans. The pop superstar performed for hours in nearly 100-degree heat Friday night at Estadio Nilton Santos stadium in Rio de Janeiro…"	3	Eras Tour
AEW's Tony Khan Takes Credit for Taylor Swift Eras Tour London Shows	"Comrades, connoisseurs of the squared circle and the catchy pop hook alike, gather 'round! It is I, your El Presidente, coming to you live from a lavish banquet inside the gilded halls of my secret volcanic lair. Today, we toast to strategic alliances and ser…"	2	Eras Tour
Taylor Swift Postpones Saturday Night's 'Eras Tour' Show in Rio Due to Extreme Temperatures	"Sad news for Swifties. On Saturday afternoon (November 18), Taylor Swift announced that she was postponing her Eras Tour show scheduled for later that night in Rio de Janeiro, Brazil due to the extreme temperatures. Keep reading to find out more… “I’m writing…"	3	Eras Tour
Rachel Zegler Recalls Having Food Poisoning & a 'Mental Breakdown' at Taylor Swift's 'Eras Tour'	"Rachel Zegler is opening up about her love for Taylor Swift and her emotional night at the Eras Tour show in New Jersey. On Thursday (November 16), the Hunger Games star appeared on The Tonight Show and revealed that she had food poisoning at Taylor‘s first E…"	3	Eras Tour
"Heather Morris Dishes on Her Podcast 'The Bystanders', Relationships With 'Glee' Costars, & 'The Eras Tour' vs. 'The Renaissance Tour' (Exclusive)"	"Heather Morris is opening up about her murder mystery podcast, her former Glee costars, and Beyoncé and Taylor Swift! The 36-year-old multi-hyphenate creative is best known for playing her Glee character, Brittany Pierce, who she calls “the GOAT.” Not to ment…"	2	Eras Tour
Taylor Swift Postpones Show in Brazil Due to Extreme Heat	"️ | Tonight’s Eras Tour show has been postponed due to extreme heat “The safety and well-being of my fans, fellow performers and crew has to and always will come first.” - Taylor #RioTSTheErasTour #TSTheErasTour pic.twitter.com/8qhuWtvF47 — Taylor Swift Up…"	3	Eras Tour
Christ The Redeemer (Taylor’s Version)	"All throughout Taylor Swift’s Eras Tour, cities have bent over backward to welcome her to town, but the latest gesture from Rio de Janeiro surpasses all the rest. Thursday, with Swift arriving in town for her run of shows at Estadio Nilton Santos, a Swift-the…"	2	Eras Tour
Don’t Expect Taylor Swift’s Concert Film To Hit Streamers This Year	"Taylor Swift's blockbuster 'Taylor Swift: The Eras Tour,' is still performing well at the box office, and it won't be available to stream until at least January."	2	Eras Tour
Brazilian Fans Want to Make Jesus a Swiftie	A group of Swifties are praying they can honor Taylor Swift with a projection onto Rio de Janeiro’s Christ the Redeemer statue ahead of her Eras-tour shows.	1	Eras Tour
Taylor Swift's Secret Songs Left for Eras Tour: Every Song She Hasn't Performed Yet	Taylor Swift performs two surprise songs for the acoustic set during every show of her Eras Tour and she has already performed a ton of incredible tracks during the first U.S. leg. The 33-year-old singer is getting ready to continue the South American leg of …	2	Eras Tour
When Devotion Drives Demand: Taking A Page From The Eras Tour	"Driven by insatiable fan devotion, the Eras Tour juggernaut has blown the value line out of the water."	2	Eras Tour
"Why Is Taylor Swift’s Eras Tour Movie Not Shown on Mondays, Tuesdays, or Wednesdays?"	"Taylor Swift‘s Eras Tour Movie is surprisingly screened only on Thursdays, Fridays, Saturdays, and Sundays, and fans want to know why it’s not showing on Mondays, Tuesdays, or Wednesdays. Here is all you need to know. Why is Taylor Swift’s Eras Tour movie not…"	2	Eras Tour
"The Strikes Are Over, but the Damage to Theaters Has Just Begun"	"Taylor Swift, ""Barbie,"" ""Oppenheimer,"" and ""Sound of Freedom"" saved 2023. Next year will need more surprise blockbusters to paper over the gaps."	1	Eras Tour
Swifties Think Taylor Swift Made a Big Revelation About Travis Kelce Onstage at the 'Eras Tour'	"Taylor Swift returned to her Eras Tour on Thursday night (November 9), and some Swifties are convinced that she used the opportunity to make a big revelation about Travis Kelce. The 33-year-old pop titan took the stage at Estadio River Plate in Buenos Aires, …"	2	Eras Tour
Taylor Swift Goes Barbiecore in Pink Versace ‘Lovers’ Outfit for Eras Tour in Buenos Aires	"After a hiatus, Swift resumed the Eras Tour — in Versace."	2	Eras Tour
Here's Why Taylor Swift Didn't Attend Beyonce's Movie Premiere After Bey’s Surprise 'Eras Tour' Premiere Appearance	"Taylor Swift is missing the premiere of Beyonce‘s new movie Renaissance: A Film By Beyonce on Saturday night (November 25), but she has a very good reason. If you forgot, the “Break Me Soul” superstar was a surprise celebrity guest on the red carpet when Tayl…"	2	Eras Tour
"Dolly Parton, Taylor Swift, and more celebrities with species named after them"	"Some scientists love naming new species after celebrities. From David Bowie's spider to Dolly Parton's lichen, here are famously named species."	2	Global influence
What Taylor Swift Can Teach Us About Leadership	"Taylor Swift isn’t just an incredibly savvy entrepreneur, she consistently demonstrates sophisticated leadership qualities that can be applied in any workplace:"	1	Global influence
IDFA’s Orwa Nyrabia Criticizes Documentary Distributors For “Populist” Mentality And Playing It Safe: “You Cannot All Live Off Taylor Swift”	"Documentary’s gatekeepers are playing it awfully safe lately, in the estimation of Orwa Nyrabia, artistic director of the International Documentary Festival Amsterdam, the world’s largest documentary film festival.  In conversation with Deadline before the st…"	2	Global influence
9 market themes to discuss around the Thanksgiving table	"There's plenty in markets to talk about while passing the potatoes on Thanksgiving. Inflation, work, artificial intelligence, labor strikes, and even Taylor Swift may be fodder for Turkey Day table talk. To help guide your discussions, here's what top executi…"	2	Global influence
8 Famous Songs Where the Singer Is Clearly Lying to Us	"We see through you, Taylor Swift. All the clues are there"	3	Global influence
Is anyone else just finding out about Simu Liu's music career?	"Perhaps inspired by Drake’s surprise album release today, or even mega-stars like Beyoncé and Taylor Swift who’ve seen huge returns from similar strategies in the past, Marvel actor and one-of-the-Kens Simu Liu is banking on nothing but the power of his stard…"	2	Global influence
"BTS, Taylor Swift and the influence of pop music fans"	Swifties and the like have proven they can exert their influence for political and social change	2	Global influence
Could Taylor Swift Trigger The Next American Baby Boom?	A blog post published in early October predicted that Taylor Swift will create the next baby boom ... and we&#039;re so here for it!	2	Global influence
'It's refreshing': Wall Street analysts show they're Taylor Swift superfans too by riffing on her songs in their usually wonky research notes	Analysts are giving a nod to Swift’s reign at the pinnacle of pop culture by referencing her lyrics in their financial research.	1	Global influence
Brazilian Swifties want to literally make Taylor Swift as big as Jesus	"Taylor Swift is exactly as big as Jesus—or at least she will be if Brazilian Swifties have their way. Over the course of The Eras Tour, we’ve been following the way each tour stop scrambled to express deference and devotion to the conquering pop star. In the …"	1	Global influence
"Taylor Swift Money Jar Goes Viral, Husband Makes Wife Pay For Taylor Talk"	"A husband's going viral for putting a Taylor Swift tip jar in his house, and making his wife pay up for every mention of the pop star OR her boyfriend, Travis Kelce! Maryland resident Dana Rice shared the clip of her hubby's new ""invention,""…"	2	Global influence
Why Do Swifties Think Taylor Swift Wrote the 'Argylle' Novel?	"A few weeks ago, a new trailer caught my eye. It was for a spy comedy thriller called Argylle, and it looked like it was a ton of fun. Apparently, that movie is based on a book with the same title, which is set to be released on January 4, 2024. The adaptatio…"	2	Global influence
NFL 2023 Midseason Report Reveals Jump In Overall Betting With Taylor Swift Effect In Full Force	"BetMGM released a 2023 midseason NFL betting report. Chiefs, Eagles most popular & Super Bowl favorites. Betting data & information you can bet on."	1	Global influence
Why is Taylor Swift so popular?	The pop star is currently the most listened-to artist on the planet thanks to her legion of devoted superfans. But what’s behind her mass appeal?	2	Global influence
"Gen Z's financial icons revealed: Taylor Swift beats Warren Buffett, and Bill Gates tops the list"	"Bill Gates, Beyoncé, and Oprah Winfrey made the list of people who embody financial success for Gen Z, according to a new survey of college students."	1	Global influence
Gannett hired a Taylor Swift writer. Now what?	"I have to admit, the first quote I saw from the new Taylor Swift beat writer for Gannett made me roll my eyes and shake my head. Bryan West, the […] The post Gannett hired a Taylor Swift writer. Now what? appeared first on Poynter."	2	Global influence
Merry Swiftmas! Amy Scott creates viral Naperville 'Taylor Swift house' on Atlas Lane after being inspired by 'Eras Tour' movie	Merry Swiftmas! Amy Scott creates viral Naperville 'Taylor Swift house' on Atlas Lane after being inspired by 'Eras Tour' movieabc7chicago.com	2	Global influence
I'm a Swiftie Dad who traded a family summer vacation to take my kids across the country to an Eras Tour concert. It was worth every penny.	"Instead of Disney World or the beach, we took the girls to see their favorite artist for the second time."	1	Global influence
"Taylor Swift Tickets, Paris Trips and Dining Out: Consumers Splurge Even as Savings Fall"	"YOLO consumers splurging on entertainment, travel and dining out are boosting the economy, but their savings are taking a hit."	2	Global influence
"15 Taylor Swift-approved Black Friday deals of 2023, from red lipstick to a Reformation dress"	"While Black Friday sadly isn't delivering deals on Eras Tour tickets (if only!), Swifties can save big on the superstar's fashion and beauty favorites."	2	Global influence
"Hottest baby name trends of 2023: How Taylor Swift, 'Wednesday' and 'Barbie' are inspiring parents-to-be"	"Baby name experts are sharing the hottest trends from the past year that inspired expectant parents. From Taylor Swift's albums to films and athletes, here are the highlights from 2023."	1	Global influence
Las Vegas Is Readying For A Lavender Haze As Raiders Play Chiefs	"Swifties are known for their Taylor Swift fandom, of course, but not often known for being wild about football."	2	Global influence
Erin Andrews’ Go-To Karaoke Songs Are Classic Taylor Swift Hits	"Erin Andrews is a Swiftie, so it’s no surprise what she chooses when it’s her turn at the karaoke bar. “My go-to karaoke song is anything from Taylor Swift’s 1989 (Taylor’s Version), especially ‘Style’ or ‘Blank Space,'” Andrews, 45, exclusively tells Us Week…"	1	Global influence
"Meet the typical Swiftie: A white suburban millennial woman who may have spent $1,300 to go to the Eras Tour"	"Taylor Swift. Fernando Leon/TAS23/Getty Images for TAS Rights Management It's no secret that Taylor Swift helped prop up the US economy over the last year. The typical Swiftie is spending $1,300 to go to the Eras Tour but might make under $50,000. Swifties sk…"	1	Global influence
Swifties Threaten To Boycott Netflix When ‘Taylor Swift: The Reputation Stadium Tour’ Is Removed Next Month: “Does Netflix Realize How Many People Are Going To Cancel Their Subscription?”	"After five years, Taylor Swift: The Reputation Stadium Tour is reportedly leaving Netflix."	2	Global influence
The Taylor Swift Effect	These activated communities can have a huge impact on sales and businesses.	2	Global influence
A Taylor Swift-Themed Cruise Will Set Sail In 2024	"For Swifties who couldn’t attend the Eras Tour, you could trade friendship bracelets at sea, instead. Learn about the Taylor Swift-themed cruise setting sail in 2024."	2	Global influence
Everything you need to know about the Taylor Swift themed cruise	"A Taylor Swift themed cruise is setting sail next year, giving Swifties the chance to experience their wildest dreams."	2	Global influence
"‘Dancing With the Stars’ Taylor Swift Night: Harry Jowsey, Rylee Arnold take Page Six inside rehearsals"	The “Too Hot to Handle” star and his pro partner exclusively took Page Six behind-the-scenes of their rehearsals for the upcoming Swift-themed episode. Watch a sneak peek of their routine.	2	Global influence
"Yes, Royal Caribbean has a cruise for Taylor Swift fans"	"Taylor Swift already has a major presence on Royal Caribbean cruise ships. She's a popular part of the playlist from the various DJs on board, and the live artists in the pub and Schooner Bar often cover her songs. One pub guitarist, Ellie Finnerty, who earli…"	2	Global influence
Choreographer Mandy Moore Is Judging DWTS' Taylor Swift Night	"Choreographer Mandy Moore is ready to watch the remaining Dancing With the Stars contestants shake it off. The competition show announced that the Nov. 21 episode will be ""A Celebration of Taylor..."	2	Global influence
‘Live With Kelly & Mark’ Treated To Largest Audience In Over A Year For Taylor Swift-Inspired Halloween Episode	"EXCLUSIVE: No tricks, just treats for this year’s Halloween episode of Live with Kelly and Mark. Live’s Halloween: The Eras Show scored 2.9M viewers on October 31, making it the most-watched Halloween episode in four years, according to Nielsen data. This is …"	2	Global influence
All Aboard the Taylor Swift Cruise	"The Eras Tour is coming to the high seas, sort of. Taylor Swift fans will be setting sail on a Taylor-themed Royal Caribbean cruise next year."	1	Global influence
"Taylor Swift Surprises 'DWTS' Cast, Sends Message of Support for Her Music-Themed Episode!"	Taylor Swift made a surprise appearance on Dancing With the Stars on Tuesday night (November 15) via a pre-recorded video message! The 33-year-old entertainer appeared on the screen in the ballroom surprising the dancers and viewers ahead of the upcoming “A C…	1	Global influence
‘Dancing With The Stars’ Announces First Taylor Swift Night	"ABC finally confirmed that there will be a Taylor Swift-themed night on 'Dancing With the Stars' this season. Here's when to tune into “A Celebration of Taylor Swift."""	2	Global influence
"A Taylor Swift Airbnb is a bachelorette dream home where megafans can bask in her ""Eras"" for up to $1,400 a night"	"You can rent this Taylor Swift Airbnb in Scottsdale, Arizona. Each room is devoted to a different era, from ""Reputation"" to ""Lover"" to ""Folklore."""	2	Global influence
The world's first Taylor Swift trivia escape room is coming to Toronto	"A Taylor Swift-themed escape room is coming to Toronto — tailor-made for the Swifties in the city. Courtesy of Trivia Escape Rooms on 1615 Dupont St., the room is available for advanced bookings before it officially opens on Dec. 13 (Taylor's birthday). It w…"	2	Global influence
"Lyft has unveiled a new 'Extra Comfort' option with better cars, drivers and options"	"A ""Frozen"" land comes to Disneyland in Hong Kong, and Taylor Swift fans are getting their own cruise."	2	Global influence
Jason Mraz reflects on working with ‘generous’ Taylor Swift and performing to her songs on ‘Dancing With the Stars’	"In an exclusive new interview with Page Six, the singer recalled what it was like performing “I’m Yours” with the pop star during her “Speak Now” tour stop in Los Angeles in 2011."	1	Global influence
Taylor Swift Surprises 'Dancing With The Stars' Fans With Special Message	"Taylor Swift grooved her way onto the ""Dancing with the Stars"" stage ... surprising contestants and the audience with a special video message for the night's theme ... ""A Celebration of Taylor Swift.” ""Hey guys, it’s Taylor. I just want to say…"	1	Global influence
It Was Taylor Swift Night On Dancing With The Stars And Jason Mraz Got A Perfect Score	"Taylor Swift currently has the #1 song in America, once again, and that feels like small potatoes for her. At this point, Swift is basically bigger than popular music these days, and everything she does is a cultural event. Taylor Swift shows up in Brazil, an…"	1	Global influence
'Dancing With the Stars' Scores Revealed for All 6 Contestants on Taylor Swift Night	Week eight of Dancing With the Stars has come to a close and the scores have been revealed! Episode nine of ABC’s dancing competition series aired on Tuesday night (November 21) and the 6 couples took to the ballroom for “Taylor Swift Night” with guest judge …	2	Global influence
ABC Exec Reacts to Report That Swifties Got Harry Jowsey Eliminated From 'Dancing With the Stars'	"An ABC executive is speaking out about Harry Jowsey‘s elimination from Dancing With the Stars. The network exec reacted to the theory online that Taylor Swift‘s fans, the Swifties, had a hand in eliminating the 26-year-old reality TV star from the competition…"	2	Global influence
Taylor Swift Brings Good Luck to ‘DWTS:’ Harry Jowsey Is Sent Packing	"Eric McCandless/Disney First, Taylor Swift came for Harry Styles. Now, the singer eliminated Harry Jowsey from Dancing With the Stars. All people named Harry ought to watch their back. Who’s next—Prince Harry?Tuesday night was the highly anticipated Taylor S…"	1	Global influence
DWTS' Tribute to Taylor Swift Deserves a Mirrorball Trophy	"Dancing With the Stars has entered its Taylor Swift era. On Nov. 21, the ABC dance competition celebrated the superstar singer with a night dedicated to her greatest hits. Of course, they did it..."	2	Global influence
‘Dancing With The Stars’ Week 9: Record Number Of Voters Send Someone Home On Taylor Swift Night	"Admit it: you started this episode knowing who was going to go home, right? If you are a true student of Dancing with the Stars, you should be able to predict the order in which the celebs are given the boot. Sure, there is the occasional misstep; many of you…"	2	Global influence
'Dancing With the Stars' 2023 Spoilers: Who Went Home on Night Nine? See Here!	SPOILER ALERT – Do not continue reading if you don’t want to know what happened on Dancing With the Stars’ latest episode! Episode nine of Dancing With the Stars just aired on ABC on Tuesday (November 21). 6 contestants competed on the show for week eight on …	2	Global influence
Dancing with the Stars 32x9	32x9: A Celebration of Taylor SwiftThe six remaining couples dance to the music of Taylor Swift; guest judge Mandy Moore.partner dances Alyson & Sasha - cha cha (7+7+8+7=29)Ariana & Pasha - rumba (9+9+9+10=37)Jason & Daniella - Argentine tango (10+10+10+10=40…	2	Global influence
Did Harry Jowsey Kiss Rylee Arnold During Their ‘DWTS’ Rumba? He Says ...	"Harry Jowsey is clearing the air on his speculated kiss with Rylee Arnold during Dancing With the Stars’ Taylor Swift Night. “Oh no, we didn’t kiss during the dance,” Jowsey, 26, said to Entertainment Weekly in a Wednesday, November 22, interview. The reality…"	2	Global influence
‘Dancing With the Stars’ Semi-Finalists Revealed After Taylor Swift Night	"It feels like the perfect night… to send another couple home. On Tuesday night’s “Dancing With the Stars,” each pair took on a Taylor Swift song. Mandy Moore, the lead choreographer on the “Eras Tour” joined the ballroom as the guest judge and was very impres…"	2	Global influence
‘Dancing With the Stars’ Week 9: Jason Mraz Retakes the Lead on Taylor Swift Night	This article contains spoilers for the Nov. 21 episode of “Dancing With the Stars” The remaining six couples danced to songs by Taylor Swift on Tuesday night of “Dancing With the Stars.” Eras tour choreographer Mandy Moore sat in as guest judge. Swift herself…	2	Global influence
Why Swifties apparently mobilized to vote Harry Jowsey off Dancing With the Stars on Taylor Swift night	Don't doubt the Swifties.	2	Global influence
How These Under 30 Cofounders Are Taking Part In The Women’s Health Revolution	"The Future of Women's Health and a Taylor Swift-Themed Cruise, plus more from the Forbes 30 Under 30 community."	2	Global influence
"Instead of Taylor Swift beat reporters, we need Nextdoor beat reporters"	"It’s time for a local news version of the much-cited Willie Sutton quote (about why he robs banks). In addition to creating news websites and trying to lure people to […] The post Instead of Taylor Swift beat reporters, we need Nextdoor beat reporters appeare…"	2	Miscellaneous Facts
"Instead of Taylor Swift beat reporters, we need Nextdoor beat reporters"	"It’s time for a local news version of the much-cited Willie Sutton quote (about why he robs banks). In addition to creating news websites and trying to lure people to visit them, we should place reporters where readers already are. And where are they? Nextdoo…"	2	Miscellaneous Facts
Fact Check: Taylor Swift Was Photographed Eating Ice Cream as Children Cry?	An image shared in November 2023 authentically showed Taylor Swift holding an ice cream cone as children cry beside her.	2	Miscellaneous Facts
"Marvel President Addresses Harry Styles' Return to Franchise, Taylor Swift 'Deadpool 3' Rumors"	"What are the chances of Harry Styles returning to the Marvel Cinematic Universe and Taylor Swift joining it? Marvel president Kevin Feige just addressed both rumors! If you forgot, the 29-year-old “Watermelon Sugar” superstar made his introduction to the MCU …"	2	Miscellaneous Facts
"John Mayer's Famous Exes Include Taylor Swift, Jennifer Aniston & More: Full Dating History Revealed!"	"We’re taking a look back at John Mayer‘s love life! Back in November 2022, the 45-year-old “Free Fallin’” singer sparked romance rumors with this 22-year-old actress after they reportedly spent over four hours together “hanging out” at a restaurant. PHOTOS: C…"	2	Miscellaneous Facts
Brittany Mahomes Shares Look Into Girls’ Night Out With Taylor Swift	This squad already has a big reputation.  And they're continuing to prove just how fabulous they are. Brittany Mahomes recently gave an inside look into her recent night out with her new...	2	Miscellaneous Facts
Taylor Swift accused of witchcraft by MAGA pastor Hank Kunneman	"Hank Kunneman is employed as a MAGA pastor. It's not bad work if you can stomach spouting uncreative and discredited conspiracy theories to dimwitted, credulous, and perpetually enraged Trump worshippers. If you know who Kunneman is, you probably remember him…"	3	Miscellaneous Facts
Taylor Swift Debuts On Brittany Mahomes' Instagram W/ Boozy Photo	Taylor Swift and Brittany Mahomes' friendship is Instagram official ... 'cause the wife of the Chiefs superstar QB finally shared a personal pic from their weekend in NYC where the singer spent some quality time with a few fellow K.C. WAGS! Of…	2	Miscellaneous Facts
Taylor Swift & Magic Johnson’s Financial Playbook: Compounding Wealth Like Billionaires	Taylor Swift and Magic Johnson are newly-minted billionaires through their talent. But this simple investment strategy could offer anyone a path to wealth.	2	Miscellaneous Facts
Taylor Swift Was Out Enjoying New York City With Her Ladies	As she should! The post Taylor Swift Was Out Enjoying New York City With Her Ladies first appeared on Go Fug Yourself.	2	Miscellaneous Facts
The Beatles Dethrone Taylor Swift On Spotify	"The Beatles are back with their first new single in decades, and their fans are showing up to support the tune."	2	Miscellaneous Facts
Elon Musk appears to have given up on trying to camouflage his private-jet travels with an FAA program used by Jeff Bezos and Taylor Swift	"Elon Musk had signed up for the FAA's PIA program that allows private jet owners to fly incognito, but he appears to have stopped using it for now."	2	Miscellaneous Facts
Taylor Swift earnings visualized with bracelet beads	Bloomberg estimates that Taylor Swift reached billionaire status with her recent touring and music releases. Swift achieved the milestone mostly with music. Bloomberg provides the visual splits wit…	2	Miscellaneous Facts
This Spotify hack transformed my music — thanks to Taylor Swift	"In the world of music streaming, every note and nuance counts. And thanks to Taylor Swift, indirectly, I've found a hidden setting that you need to turn OFF to have the best experience with your music on Spotify."	1	Miscellaneous Facts
"Taylor Swift, Brent Faiyaz, Silvana Estrada, and More: This Week’s Pitchfork Selects Playlist"	"Our weekly playlist highlights songs that our writers, editors, and contributors are listening to on repeat"	1	Miscellaneous Facts
Celebrities Attend The Renaissance: A Film by Beyoncé Red Carpet Premiere	"Michelle Williams poses for photos at the premiere of Beyoncé's #Renaissance concert film. pic.twitter.com/5VNCbvpYxK — Variety (@Variety) November 26, 2023 Celebrities are out tonight, attending the red  chrome carpet premiere for Renaissance: A Film by B…"	2	Miscellaneous Facts
"60% off Select Taylor Swift Vinyls, 50% off Select Kodak Film Cameras, 50% off Select Pre-Loved Zimmermann @ eBay"	Part of eBay Black Friday's Test your knowledge 60% off* Taylor Swift vinyls  1 txn pp. Max disc $39. Select items. 130 codes available. T&Cs apply Q: Name Taylor Swift's second album A: FEARLESS 50% off* Kodak film cameras  1 txn pp. Max disc $50…	2	Miscellaneous Facts
Deadpool 3: Ryan Reynolds Loves Taylor Swift MCU Rumors	"After receiving the prestigious Order of British Columbia, Deadpool star Ryan Reynolds addressed recent Taylor Swift MCU rumors for the highly-anticipated third installment. Speaking with Vancouver Sun, Reynolds didn’t confirm nor deny Swift’s involvement in …"	1	Miscellaneous Facts
DEADPOOL 3 Officially Resumes Shooting As Ryan Reynolds Chimes In On Recent Taylor Swift Rumors	"One of Deadpool 3's executive producers has confirmed that the Marvel Studios threequel has resumed shooting in the UK, while Ryan Reynolds has broken his silence on rumours of a Taylor Swift cameo..."	2	Miscellaneous Facts
Is Taylor Swift in Deadpool 3? Ryan Reynolds has his say	Deadpool 3 star Ryan Reynolds shares cryptic reaction to Taylor Swift cameo rumors	2	Miscellaneous Facts
Beyoncé Drops Surprise Second Trailer for ‘Renaissance’ Tour Film	"Beyoncé fans already have Friday, December 1 marked on their calendars. That’s the day the polymath’s concert documentary, Renaissance: A Film by Beyoncé, is set to hit theaters—and the day when the concert film box office records set by Taylor Swift: The Era…"	2	Miscellaneous Facts
"Ryan Reynolds Breaks Silence on ‘Deadpool 3’ Cameo, “Loves” Taylor Swift Rumors"	"The infamous Merc with a Mouth is gearing up for his long-awaited return in Sony Pictures and Marvel Studios’ Deadpool 3, which, after being subject to a bit of reshuffling, now has an official 2024 release date. Ryan Reynolds’ titular anti-hero aside, a diff…"	1	Miscellaneous Facts
Beyoncé Hypes ‘Renaissance’ Tour Film With New Trailer During Macy’s Thanksgiving Day Parade	"The season is upon us, by which we mean the concert tour movie season. While it’s unlikely she’ll be able to top the surprise success of Taylor Swift’s “Eras Tour” film, Beyoncé’s getting the hype out by dropping a brand new trailer. She did it in what was to…"	2	Miscellaneous Facts
"Record Store Day Black Friday’s Most Wanted: Olivia Rodrigo’s Must-Have EP, Plus Vinyl Exclusives From Noah Kahan, Nas, Joni Mitchell and More"	“Brutal out there” may be a good description for how Record Store Day Black Friday will feel for those customers who have their appetites set only on the limited-edition piece that Olivia Rodrigo has coming out for the occasion. Rodrigo is essentially playing…	2	Miscellaneous Facts
Fans mock Tony Romo after reaction to Dolly Parton performance: Dolly is hotter than Taylor Swift	"Tony Romo, part of the CBS team covering the Dallas Cowboys&apos; Thanksgiving game, witnessed Dolly Parton&apos;s captivating halftime show, where she wore a bedazzled Cowboys che"	3	Miscellaneous Facts
Ryan Reynolds breaks silence on Taylor Swift's Deadpool 3 role: Here’s what he revealed	"In the expansive Marvel Cinematic Universe, buzz surrounds rumors of Taylor Swift possibly portraying Dazzler in Deadpool 3. Ryan Reynolds, Deadpool's lead has addressed the speculation."	2	Miscellaneous Facts
Bankers turn up in $600 sneakers for a chance at Golden Goose IPO	"Bankers are vying for roles in Golden Goose's initial public offering, with at least 20 banks wearing Golden Goose sneakers during pitch meetings. The luxury Italian shoemaker's $600 sneakers are worn by celebrities like Selena Gomez and Taylor Swift."	2	Miscellaneous Facts
Joe Biden Mistakes Britney Spears for Taylor Swift in Pre-Thanksgiving Speech	"Joe Biden got a little mixed up in his pre-Thanksgiving speech. During the annual turkey pardoning on Monday (November 20), which also happened to be his 81st birthday, the President talked about the difficult journey the turkeys went through after traveling …"	2	Miscellaneous Facts
"Biden turns 81, pardons turkeys, confuses Taylor Swift with Britney Spears"	"""That's a big bird, man. I'm impressed"" Biden said during the ceremony where he confused Britney Spears and Taylor Swift."	2	Miscellaneous Facts
Biden Confuses Taylor Swift With Britney Spears in Awkward Turkey Pardon Moment	"Leah Millis/Reuters In a lighthearted pre-Thanksgiving ceremony where Joe Biden granted pardons to turkeys Liberty and Bell at the White House on Monday, the president (gasp!) appeared to confuse Taylor Swift with Britney Spears. In a reference to the more t…"	2	Miscellaneous Facts
Biden Confuses Taylor Swift With Britney Spears After Joking About His Age On His 81st Birthday	Biden quipped about “turning 60” during the White House annual Thanksgiving turkey pardon Monday.	2	Miscellaneous Facts
"Biden Struggles Through Incomprehensible Joke About Taylor Swift, Britney Spears, and Brazil at Turkey Pardoning"	President Joe Biden struggled through an incomprehensible joke about Taylor Swift’s concert in Rio de Janeiro during the turkey pardoning ceremony at the White House on Monday after a woman died due to the heat at Swift’s performance there on Friday night. Bi…	2	Miscellaneous Facts
Joe Biden Says Britney Spears is Touring in Brazil	"Joe Biden mistakes Taylor Swift for Britney Spears in turkey pardoning speech:“This is harder than getting a ticket to the Renaissance tour, or for Britney’s tour…it’s kind of warm in Brazil right now” pic.twitter.com/voifWHqLG6 — Pop Crave (@PopCrave) Novem…"	2	Miscellaneous Facts
"‘We don’t hold anything back’: meet the Old Gays, TikTok’s most influential pensioners"	"No written description quite captures the joy-inducing positivity of their online videos: bopping along to Taylor Swift in slinky striped swimwear; countless dance trends and TikTok challenges, completed in various seductive states of undress. Twirling and wh…"	2	Miscellaneous Facts
Hollywood's Biggest Celebs Fly High In Their Private Jets	"It's The Only Way We Fly!!! Hollywood's biggest stars are flying high these days ... eschewing commercial air travel for a more luxurious and lavish experience ... in their own private aircrafts. Big-time celebs like Kim Kardashian, Taylor Swift, Beyoncé, Joh…"	2	Miscellaneous Facts
‘Renaissance: A Film By Beyonce’ Hopes To Pull In More Than The Single Ladies With $20M+ Opening	"EXCLUSIVE: So AMC’s second concert movie, Renaissance: Film by Beyonce hit tracking recently with a $20M opening projection. You’ll remember that the No. 1 circuit in the world, which is distributing the movie to other exhibitors through Variance (who was tap…"	2	Miscellaneous Facts
Drake shouts out Taylor Swift on surprise release	"Well, it looks like Drake’s tummy isn’t hurting so much anymore. Just weeks after announcing he’d be taking an extended break from music to deal with some health complications—specifically the fact that he’d been having “the craziest problems for years with […"	1	Music Releases
Drake Honors Taylor Swift With His New Song ‘Red Button’	"Drake raps about Taylor Swift on his new song ""Red Button,"" which is featured as part of his just-released Scry Hours 3 collection."	1	Music Releases
Is the Taylor Swift Reputation (Taylor’s Version) Release Date November 26?	"Fans are hyped for the Taylor Swift Reputation (Taylor’s Version) release date, with many believing that it will be coming out on November 26, 2023. Here’s the latest information about the potential launch date of this new TV album. Is the Reputation (Taylor’…"	2	Music Releases
Drake Praises Taylor Swift: “Only One Could Make Me Drop the Album Just a Little Later”	"The rapper shouts out the fellow pop star on his new Scary Hours 3 cut ""Red Button."" Drake Praises Taylor Swift: “Only One Could Make Me Drop the Album Just a Little Later” Eddie Fu"	1	Music Releases
Drake's 'Red Button' Lyrics Mention Taylor Swift & Pushing Back Album Because of Her	"Drake just dropped his new album Scary Hours 3 and it features the song “Red Button,” which mentions Taylor Swift. After throwing some shade at the success of Taylor‘s album Midnights last year, Drake is now admitting that she’s the only person who can get hi…"	1	Music Releases
Easter eggs that hint at Taylor Swift dropping ‘reputation’ next	This time the Swifties are guessing that the musical sensation is going to announce that she will be rereleasing her “reputation” album next	2	Music Releases
Drake Shouts Out Taylor Swift on New Song for ‘Scary Hours 3’ Album: Listen	The rapper made sure to praise the 'Anti-Hero' songstress and revealed that he postponed his album for her on his new record released on November 16.	1	Music Releases
"A Taylor Swift song is the best investment advice for 2024, Goldman Sachs says"	This isn't the first time Taylor Swift has occupied the head space of Wall Street forecasters and economists this year.	1	Music Releases
"Diane Warren Touts Cool ’80 For Brady’ Cast, Singers & Taylor Swift – Sound & Screen Film"	"Diane Warren lined up an all-star girl group including Debbie Harry, Dolly Parton, Belinda Carlisle, Cyndi Lauper and Gloria Estefan to sing “Gonna Be You,” from the film 80 for Brady. “I love great artists,” Warren said Thursday at Deadline’s Sound and Scree…"	2	Music Releases
"‘The Buccaneers’ Director Susanna White Talks ‘Bridgerton’ Comparisons & Taylor Swift, Reveals Feature Developed For BFI About Her Teen Years"	EXCLUSIVE: Veteran British director Susanna White has revealed she’s working on debut feature film based on her teenage life in the fashion world as she gears up for today’s launch of Apple TV+ period drama The Buccaneers. White is developing an untitled scri…	2	Music Releases
Kelly Clarkson Says Taylor Swift Sends Her Flowers After Every Re-Recording Release	"Kelly Clarkson knows all too well how sweet Taylor Swift is. The superstar revealed to E! News that the “Anti-Hero” superstar sends her gifts after album releases. “You know what’s so funny? She just sent me flowers,” The Kelly Clarkson Show host shared. “She…"	1	Music Releases
Why Taylor Swift Sends Kelly Clarkson Flowers After Every Re-Recording	"Now this gesture is so gorgeous. Kelly Clarkson recently revealed the sweet gift she received from Taylor Swift and fans won't be able to shake it off. ""You know what's so funny? She just sent me..."	2	Music Releases
Taylor Swift swerves expectations again with new 1989 track “Slut!”	The prologue to 1989 (Taylor’s Version) explains exactly the kind of scrutiny that the original 1989 album was made under. “I had become the target of slut shaming—the intensity and relentlessness of which would be criticized and called out if it happened tod…	1	Music Releases
"9 New Albums You Should Listen to Now: Taylor Swift, Sofia Kourtesis, and More"	"Stream new releases from Taylor Swift, Sofia Kourtesis, the Mountain Goats, Ragana, Shabazz Palaces, Murda Beatz & Shordie Shordie, Ryan Davis & the Roadhouse Band, María José Llergo, and New Age Doom & Tuvaband"	1	Music Releases
Kendrick Lamar and Taylor Swift Re-Record “Bad Blood” for 1989 (Taylor’s Version): Listen	"“Watching [Kendrick Lamar] create and record his verses on the Bad Blood remix was one of the most inspiring experiences of my life,” Swift gushed"	2	Music Releases
Is Taylor Swift About to Announce ‘Reputation (Taylor’s Version)’?	Taylor Swift has seemingly dropped hints that she plans to announce ‘Reputation (Taylor’s Version)’ during one of her Brazil ‘Eras Tour’ concerts	2	Music Releases
Lana Del Rey Explains What Happened to First Version of Taylor Swift Collab 'Snow On the Beach'	"Lana Del Rey is dishing on what really went down on the first version of her Taylor Swift collaboration “Snow On the Beach,” which is on the Midnights album. The 38-year-old songstress is featured on the track, but after it initially came out, fans noticed th…"	2	Music Releases
"Drake Is Not Only Competing Against Taylor Swift, He’s Leveraging Her Name For Another Hit"	"Drake name-dropped Taylor Swift on his new song ""Red Button,"" which is featured on the Scary Hours edition of his album For All The Dogs. That's a smart move on his part."	2	Music Releases
Taylor Swift Blocks The Beatles From Hitting No. 1	"The Beatles had two albums looking to hit No. 1 in the U.K., but neither of them could compete with Taylor Swift's '1989 (Taylor's Version).'"	2	Musical Accomplishments
Jung Kook Blocked From Making Billboard History By Taylor Swift	"Jung Kook's debut album 'Golden' has made a strong entry on the Billboard 200 chart, but it couldn't compete with Taylor Swift's '1989 (Taylor's Version).'"	2	Musical Accomplishments
Taylor Swift Matches One Of BTS’s Most Impressive Chart Feats	"Taylor Swift and BTS are the only musical acts to hit No. 1 on the Hot 100, then replace themselves with another single...then see that first win return to the summit."	1	Musical Accomplishments
Britney Spears Remembers Meeting Taylor Swift For The First Time & Calls Her “The Most Iconic Pop Woman Of Our Generation”	Britney Spears is known as the Princess of Pop and is giving Taylor Swift her flowers calling her “the most iconic pop woman of our generation.” Spears took to social media to share a throwback from 20 years ago posing in a photo with Swift before the “Bad Bl…	1	Musical Accomplishments
Taylor Swift Ensures That No Men Chart A Top 10 Hit This Week	"Not a single male artist can be found inside the top 10 on the Hot 100 this week, as Taylor Swift, Doja Cat and SZA dominate the highest reaches of the chart."	2	Musical Accomplishments
Taylor Swift Replaces Herself At No. 1 On The Hot 100–Again	"Taylor Swift's single ""Cruel Summer"" rebounds to No. 1 on the Hot 100, taking over for ""Is It Over Now?,"" which debuted atop the tally last week."	1	Musical Accomplishments
Taylor Swift Is Inching Closer To A Billboard Chart Record No One Wants	Taylor Swift has now seen nine different songs stop at No. 2 on the Hot 100—one rung shy of becoming chart-toppers.	3	Musical Accomplishments
Taylor Swift Smashes Records All The Time–But She Can’t Quite Catch Adele	Taylor Swift's new album '1989 (Taylor's Version)' scored the second-largest debut in Billboard 200 history among women...coming in behind only Adele's '25.'	3	Musical Accomplishments
The Taylor Swift phenomenon	How did the 33-year-old pop star build a record-shattering global music empire?	2	Musical Accomplishments
Gracie Abrams Reveals She & Taylor Swift 'Screamed at Each Other Over Text' About Their Grammy Nominations	"Gracie Abrams is opening up about how she and Taylor Swift reacted to their Grammy nominations! On Friday (November 10), the 24-year-old singer-songwriter was nominated for Best New Artist, and the 33-year-old Grammys veteran received six nominations in major…"	2	Musical Accomplishments
"Taylor Swift Gets Dinner With Gracie Abrams, Hours After Arriving Back in NYC From Argentina! (Photos)"	Taylor Swift and Gracie Abrams just grabbed dinner together and they definitely had something to celebrate – their Grammy nominations! The 33-year-old “Cruel Summer” singer and the 24-year-old “”I Know It Won’t Work” singer were seen leaving a meal at Freeman…	2	Musical Accomplishments
Taylor Swift Named Apple Music's Artist of the Year	"Apple today announced that Taylor Swift has been named Apple Music's Artist of the Year for 2023 after reaching ""a new realm of superstardom this year."" Swift released a new album last month called 1989 (Taylor's Version), and she has been on tour this y…"	1	Musical Accomplishments
Taylor Swift Sets Grammy Awards Record With ‘Anti-Hero’ Nomination	The “Midnights” singer received six nominations in all.	1	Musical Accomplishments
Taylor Swift named the Apple Music Artist of the Year: ‘2023 (Taylor’s Version)’	"Apple has named Taylor Swift the Apple Music Artist of the Year for 2023. “Across the charts, streams, and concert stadiums filled with screaming, bracelet-wearing super fans, Swift undeniably reached a new realm of superstardom this year,” Apple explains.  …"	1	Musical Accomplishments
Apple Music celebrates Taylor Swift as the Artist of the Year for 2023	"Taylor Swift has been named Apple Music's 2023 Artist of the Year, setting record-breaking milestones and receiving the prestigious Apple Music Award.Throughout the year, Swift achieved remarkable feats such as chart-topping songs, massive streaming numbers, …"	1	Musical Accomplishments
"Grammy Nominations 2024: Taylor Swift, SZA, Phoebe Bridgers, and Victoria Monét Lead Nominees"	"Billie Eilish, Olivia Rodrigo, and Miley Cyrus also netted multiple nominations this year"	1	Musical Accomplishments
"Taylor Swift, SZA, and Lana Del Rey Nominated for Album of the Year at the 2024 Grammys"	"Also in the running are Olivia Rodrigo, Boygenius, Janelle Monáe, Miley Cyrus, and Jon Batiste"	1	Musical Accomplishments
"Album Of The Year Grammy Nominees Include boygenius, Lana Del Rey, Olivia Rodrigo, Taylor Swift"	"This year’s Grammy nominations are coming out this morning, and we now know who will compete for the year’s biggest prize. Eight albums have been nominated in the Album Of The Year category, and most of them are both critical and commercial heavyweights. Just…"	1	Musical Accomplishments
Taylor Swift Matches One Of Michael Jackson’s Most Impressive Billboard Chart Records	"Taylor Swift collects her third Hot 100 No. 1 of 2023 with ""Is It Over Now?"" and in doing so, manages a very odd and very rare chart feat."	1	Musical Accomplishments
Taylor Swift Breaks The Record For The Most Song Of The Year Grammy Nominations	"""Anti-Hero"" gives Taylor Swift her seventh Song of the Year Grammy nomination, which breaks her tie with Paul McCartney and Lionel Richie for the most ever."	1	Musical Accomplishments
Taylor Swift Ties The Record For The Most Album Of The Year Grammy Noms Among Women	"Taylor Swift collects her sixth Album of the Year Grammy nomination, tying Barbra Streisand for the most nods among women ever."	1	Musical Accomplishments
Taylor Swift Breaks Her Hot 100 Tie With And BTS Ariana Grande	"Taylor Swift's new single ""Is It Over Now?"" starts its time on the Hot 100 at No. 1, giving the singer her sixth debut atop the competitive Billboard chart."	1	Musical Accomplishments
"Taylor Swift, SZA And Jon Batiste: These Are The Album Of The Year Grammy Nominees"	"There aren't many shocks in the Album of the Year category at this year's Grammys, with names like Taylor Swift, SZA and Olivia Rodrigo leading the charge."	1	Musical Accomplishments
"2024 Grammy Predictions: Taylor Swift, SZA And ‘Barbie’ For Album Of The Year"	Will Taylor Swift win the Album of the Year Grammy for a record-setting fourth time in 2024? She certainly seems like a lock for a nomination.	1	Musical Accomplishments
Taylor Swift Ties Bad Bunny As She Claims The No. 1 Song In The World	"Taylor Swift's ""Is It Over Now?"" is the biggest song in the world, and this week doesn't mark the first time she's hit No. 1 on the Billboard Global 200."	1	Musical Accomplishments
Can Jung Kook Beat Taylor Swift To No. 1 On Next Week’s Billboard Charts?	"Taylor Swift's '1989 (Taylor's Version)' is all but guaranteed to hold at No. 1 for a second week, but predictions for Jung Kook's 'Golden' have been growing."	2	Musical Accomplishments
Taylor Swift is Apple Music 2023 Artist of the Year	"Apple Music has crowned Taylor Swift as Artist of the Year for 2023, a testament to her unwavering popularity and the sheer volume of her streaming success. With a record-setting 65 songs on Apple Music's Global Daily Top 100 within just ten months, Swift's r…"	1	Musical Accomplishments
Taylor Swift Ties The Record For The Most Album Of The Year Grammy Noms Among Women	"Taylor Swift’s latest full-length album of original material, Midnights, is a contender for the Album of the Year Grammy. This comes as a surprise to absolutely no one, as the set was named as a likely nominee from the moment it dropped — and perhaps even ear…"	1	Musical Accomplishments
Taylor Swift Takes A Large Bite Out Of 2023: Named Apple Music's Artist Of The Year	"Taylor Swift was named Apple Music's Artist of the Year, solidifying her status as a global music phenomenon. Throughout the year, Swift achieved unprecedented success with 65 of her songs dominating Apple Music's Global Daily Top 100 in the first 10 months, …"	1	Musical Accomplishments
"Taylor Swift, SZA And Jon Batiste: These Are The Album Of The Year Grammy Nominees"	"What makes a release the album of the year is completely up to interpretation by Grammy voters, and that’s what has made it so difficult to predict in the past few years. The trophy has gone to some surprising titles and artists recently, but there aren’t too…"	1	Musical Accomplishments
"Taylor Swift defeats Taylor Swift, also everybody else, with sales for 1989 (Taylor's Version)"	"Taylor Swift has now officially beaten pretty much the only person on the planet giving her a real fight for pop music dominance at the moment: Herself. This is per Deadline, reporting on the first serious sales numbers for Swift’s latest release, the (Taylor…"	1	Musical Accomplishments
Taylor Swift Lands Biggest Sales Week of Her Career With 1989 (Taylor’s Version)	The album’s No. 1 debut on the Billboard 200 is the best an album has done in sales subce Adele’s 25	1	Musical Accomplishments
Taylor Swift Tops ‘Canceled’ 2023 MTV EMA Awards	"Taylor Swift, Nicki Minaj, Jung Kook and Maneskin win big at ‘canceled’ 2023 MTV EMA Awards - see full winners list"	1	Musical Accomplishments
Taylor Swift Takes 8 of the Top 10 on the Hot 100	"Swift holds most of the chart following the release of 1989 (Taylor's Version), with ""Is It Over Now?"" dethroning ""Cruel Summer"" for Number One"	1	Musical Accomplishments
"MTV EMAs 2023 Winners: Taylor Swift, Jung Kook and More"	"At teatime, everybody agrees—that Taylor Swift is the top winner at the 2023 MTV EMAs. While the originally scheduled Nov. 6 ceremony in Paris was ultimately canceled, the network still marked the..."	1	Musical Accomplishments
Taylor Swift Further Proves She Can Sell An Album Like No Musician In History	Taylor Swift has seen six different albums move at least one million copies in a single week—the most among all acts. Her new set 1989 (Taylor's Version) is the latest.	1	Musical Accomplishments
Taylor Swift Claims The Three Bestselling Albums In America In 2023	"Taylor Swift now claims the top three bestselling albums in the U.S. in 2023, led by 1989 (Taylor's Version). It's followed by Midnights and Speak Now (Taylor's Version)."	1	Musical Accomplishments
Taylor Swift Ties Whitney Houston With Her Latest No. 1 Single	"Taylor Swift's new single ""Is It Over Yet?"" marks her eleventh song to hit No. 1 on the Hot 100—the fourth most among all solo female artists."	1	Musical Accomplishments
Taylor Swift Claims Half Of All The Top 40 Songs In America This Week	Taylor Swift charts 20 top 40 hits on the Hot 100 this week as she invades the ranking with songs from her new album 1989 (Taylor's Version).	1	Musical Accomplishments
Taylor Swift Scores The Biggest Debut Of The Year With ‘1989 (Taylor’s Version)’	Taylor Swift is back at No. 1 on the Billboard 200 with 1989 (Taylor's Version). The re-recorded take of her pop blockbuster 1989 debuts in first place on the ranking of the top-consumed albums in the U.S. with the largest starting sum of 2023 by a significan…	1	Musical Accomplishments
Taylor Swift May Replace Herself Atop The Hot 100 Next Week	"Taylor Swift may replace herself at No. 1 on the Hot 100 net week, swapping ""Is It Over Now?"" for current ruler ""Cruel Summer."""	1	Musical Accomplishments
Taylor Swift Breaks The Record For The Largest Vinyl Sales Week Ever With ‘1989 (Taylor’s Version)	"Taylor Swift's 1989 (Taylor's Version) has sold at least 580,000 copies on vinyl alone in less than a week, which is a new record in America."	1	Musical Accomplishments
Taylor Swift Breaks Her Tie With Justin Bieber As ‘Cruel Summer’ Gains Again	"Taylor Swift's single ""Cruel Summer"" becomes the most-streamed song in America for the first time this week, helping her make history once more."	1	Musical Accomplishments
Is Taylor Swift the 'Person of the Year' and the best thing happening to America?	"Taylor Swift has been named &quot;Person of the Year&quot; by Wall Street Journal columnist Peggy Noonan. In an op-ed headlined &quot;We Should All Give Thanks for Taylor Swift,&qu"	1	Musical Accomplishments
Every Song That Went to No. 1 in 2023	"Artists like Miley Cyrus, Taylor Swift, and Drake defined pop music this year, reigning atop the Hot 100 chart for multiple weeks."	1	Musical Accomplishments
The Official UK Top 100 Singles Chart (2023.11.23)	"Tracklist:01. Jack Harlow - Lovin On Me (New Entry)02. Dua Lipa - Houdini (New Entry)03. cassö, RAYE, D-Block Europe - Prada04. Tate McRae - greedy05. Noah Kahan - Stick Season06. The Beatles - Now And Then07. Taylor Swift - Is It Over Now? (Taylor's Version)…"	1	Musical Accomplishments
Taylor Swift Extends Australian Chart Streak With ‘1989 (Taylor’s Version)’	"Taylor Swift makes it a full month at No. 1 in Australia with 1989 (Taylor’s Version) (via Universal), now the longest reigning of her four re-recorded albums. Swift’s latest hit LP holds off Stray Kids’ Rock-Star (Ing/Universal), unchanged at No. 2, while ho…"	1	Musical Accomplishments
Taylor Swift reigns for full month at No. 1 in Australia with 1989 (Taylor’s Version)	"Taylor Swift, one the most globally renowned American musicians has topped the charts in Australia as her latest album “1989 (Taylor’s Version)” has been on the number one position in the country for a whole month. As per reports, this re-recorded album has r…"	1	Musical Accomplishments
"ARIA Charts: Taylor Swift, Jack Harlow Extend Reigns"	Homegrown rapper Chillinit bags the highest score of the week with his mixtape “420DNA.”	1	Musical Accomplishments
We Should All Give Thanks for Taylor Swift	"Right about now Time magazine would be choosing its Person of the Year, a designation I’ve followed from childhood because their choices tend to vary from sound to interesting. Also I almost always know who they’ll choose and enjoy finding out if I’m right. H…"	1	Musical Accomplishments
Taylor Swift Ties Adele As She Continues To Rule The Hot 100	"Taylor Swift rules the Hot 100 for a fifth consecutive week, as ""Cruel Summer"" dominates once more. Now, she and Adele have spent the same number of weeks at No. 1."	1	Musical Accomplishments
"Billboard Music Awards 2023 Complete Winners List: Taylor Swift, Morgan Wallen Take Top Trophies; Karol G, Peso Pluma, Zach Bryan, Fuerza Regida Also Triumph"	"It was a big night for Taylor Swift and Morgan Wallen at the 2023 Billboard Music Awards as they both took the most trophies. Swift won in categories like Top Artist, Top Female Artist, Top Hot 100 Songwriter, Top Country Female Artist and Top Selling Song fo…"	1	Musical Accomplishments
All The Ways Taylor Swift Made History At The 2023 Billboard Music Awards	"Taylor Swift is now tied for the most Billboard Music Award wins in history with Drake, as both artists came out on top in several categories at the 2023 ceremony."	1	Musical Accomplishments
Billboard Music Awards 2023: Complete Winners List	"And the trophy goes to… The 2023 Billboard Music Awards took place on Nov. 19. As for the night's big winners, Morgan Wallen received the most accolades with 11 wins and Taylor Swift followed..."	1	Musical Accomplishments
Taylor Swift reacts to 10-prize haul at Billboard Music Awards: 'Unreal'	"Taylor Swift took home 10 wins at the Billboard Music Awards on Sunday. 'I feel like the luckiest person in the world to have you in my corner,' she told fans."	1	Musical Accomplishments
The Biggest Snubs and Surprises of the 2024 Grammy Nominations	"SZA, Taylor Swift, Victoria Monét, and Phoebe Bridgers are among the most nominated artists at the 2024 Grammy Awards."	1	Musical Accomplishments
"Boygenius, Olivia Rodrigo, and Miley Cyrus Nominated for Record of the Year at 2024 Grammys"	"SZA, Taylor Swift, Billie Eilish, Victoria Monét, and Jon Batiste are also up for the award"	1	Musical Accomplishments
"Billie Eilish, Dua Lipa, and SZA Nominated for Song of the Year at 2024 Grammys"	"Taylor Swift, Olivia Rodrigo, Lana Del Rey, Jon Batiste, and Miley Cyrus round out the nominees this year"	1	Musical Accomplishments
"The biggest snubs and surprises from the 2024 Grammy nominations: Love for Lana Del Rey, less for Drake and country music"	"While we all saw nominations for major artists like Taylor Swift, Billie Eilish, and SZA coming, the Recording Academy still managed to keep us on our toes with a number of shocking decisions. There are some artists we were pleasantly surprised to see get nod…"	1	Musical Accomplishments
‘Hunger Games: Ballad Of Songbirds & Snakes’: Spotify A Key Partner In Country Music Infused Prequel	"EXCLUSIVE: Music has continually been a facet of Lionsgate’s $3 billion Hunger Games franchise going back to ditties from Taylor Swift, Coldplay and Lorde, and with today’s theatrical release of Lionsgate’s The Hunger Games: The Ballad of Songbirds & Snakes, …"	2	Miscellaneous Facts
The Affordable Jewelry Brand Taylor Swift Keeps Wearing Out with Travis Kelce is Having a Black Friday Sale	And the sale is today only!	2	Travis Kelce
Is Bleachers’ ‘Hey Joe’ About Taylor Swift’s Ex Joe Alwyn?	Getty Image Taylor Swift and Joe Alwyn's former relationship feels as old as Travis Kelce's recently resurfaced tweets.	2	Travis Kelce
Philadelphia Radio Station Won't Play Taylor Swift Songs Ahead of Eagles vs. Chiefs	"While pop superstar Taylor Swift is a native of Pennsylvania and grew up a Philadelphia Eagles fan, her allegiance to Kansas City Chiefs star tight end Travis…"	2	Travis Kelce
Why Are People So Obsessed With Taylor Swift and Travis Kelce? Rolling Stone Staff Has Theories	Rolling Stone staffers offer their own theories as to why everyone is so obsessed with Taylor Swift and Travis Kelce's relationship.	2	Travis Kelce
Taylor Swift Music “Punted” From Philly Radio Station Until After Eagles-Chiefs Game	Listeners of Philadelphia’s Q102 won’t be hearing any Taylor Swift music this weekend: The popular radio station says the city’s football team needs no distractions prior to its game against the Kansas City Chiefs (and Swift beau Travis Kelce) Monday night. “…	3	Travis Kelce
Taylor Swift Will Bring Her Parents to Chiefs vs. Eagles Game	It's time for the parents to watch the boy on the football team.  Taylor Swift will bring her mom Andrea Swift and dad Scott Swift with her to watch the Kansas City Chiefs face off against...	2	Travis Kelce
"Jake From State Farm Says Why Taylor Swift ""Belongs"" With Travis Kelce"	"For Jake From State Farm, Taylor Swift and Travis Kelce's love story is straight out of his wildest dreams. ""It's the sweetest thing ever,"" the insurance company spokesmodel Kevin Miles told E!..."	2	Travis Kelce
Everything There Is to Know About Taylor Swift and Travis Kelce	"A comprehensive guide to all the details of Taylor Swift and Travis Kelce’s relationship, from the Eras Tour to the Chiefs games."	2	Travis Kelce
‘Kelce’ becomes top trending dog name in 2023 amid NFLer’s romance with Taylor Swift	"""Whether the name is silly or serious, most pet parents are influenced by names that remind them of their favorite things or trending pop culture moments."""	2	Travis Kelce
Travis Kelce Gives Taylor Swift Sweet Shout-Out on His Podcast	"Travis Kelce is giving Taylor Swift a special shout-out! During the Friday (November 17) episode of his New Heights podcast, the 34-year-old Kansas City Chiefs tight end and brother Jason Kelce showed off some artwork they received from fans. One cartoon draw…"	2	Travis Kelce
Taylor Swift and Travis Kelce Plotting Parents Mashup Ahead of Thanksgiving	"As Taylor Swift and Travis Kelce’s courtship continues, they’ve been rubbing elbows with each other’s parents. There’s just one group … Taylor Swift and Travis Kelce Plotting Parents Mashup Ahead of Thanksgiving was originally published on The Hollywood Gossi…"	2	Travis Kelce
Joy Behar Hurls Mean Insults At Travis Kelce In 'View' Chat On Taylor Swift Love	"""The View"" host viciously dragged the Chiefs tight end for his relationship with the pop star."	2	Travis Kelce
Why we need to stop regarding Taylor Swift and Travis Kelce’s romance as something remarkable	"Look, look, here’s the thing: I have watched the footage of Taylor Swift running towards Travis Kelce and hugging him a bazillion times now, and if you are a person who is alive and has a internet connection, or even a person who doesn’t have an internet conn…"	3	Travis Kelce
Taylor Swift Is Trying to Attend Travis Kelce's Monday Game for a Very Important Reason	"Taylor's playing a show in Brazil on Sunday night, but ""it’s really important to her to be there."""	2	Travis Kelce
Chiefs' Chris Jones Seemingly Confirms Taylor Swift Will Be at Eagles Game	"David Eulitt/Getty Images; Amy Sussman/Getty Images Kansas City Chiefs player Chris Jones appears to have insider knowledge on whether Taylor Swift is planning to attend Travis Kelce’s Monday Night Football matchup against the Philadelphia Eagles. Jones, 29, …"	2	Travis Kelce
Travis Kelce Shout Outs Taylor Swift for Putting Him ‘On the Map’	"Travis Kelce is appreciative of girlfriend Taylor Swift for making him a household name. During the Friday, November 17, bonus episode of the “New Heights” podcast, Travis, 34, and brother Jason Kelce showed off some artwork they received from fans. A cartoon…"	2	Travis Kelce
"2023 Travis Kelce jersey: Dating Taylor Swift heats up demand for home, away Chiefs gear"	Fanatics has 2023 Travis Kelce jerseys that can be shipped to old and new Kansas City Chiefs fans and Taylor Swift fans	2	Travis Kelce
Derek Jeter Speaks Out On Travis Kelce-Taylor Swift Romance	"Travis Kelce and Taylor Swift’s romance is almost certainly the biggest sports-entertainment romance in history in terms of media attention. But, former Yankees legendary shortstop Derek Jeter is no secret to high-profile relationships, and he’s weighed in on…"	2	Travis Kelce
"Chipotle's Travis Kelce, Taylor Swift Joke Goes Viral"	"People have teased the Kansas City Chiefs tight end over his ""commitment"" to misspelling in old posts he made to X."	2	Travis Kelce
Taylor Swift ‘Exiled’ From Philadelphia Radio Station Before Kelce Brothers’ Eagles vs. Chiefs Game	"“This weekend, it's really important we show our support for the Birds,"" Q102's ""Nugget"" says The post Taylor Swift ‘Exiled’ From Philadelphia Radio Station Before Kelce Brothers’ Eagles vs. Chiefs Game appeared first on TheWrap."	3	Travis Kelce
15+ Hilariously Wholesome Travis Kelce Tweets From His Life Before Taylor Swift	The post 15+ Hilariously Wholesome Travis Kelce Tweets From His Life Before Taylor Swift appeared first on Pleated Jeans.	2	Travis Kelce
Travis Kelce gives Taylor Swift a ‘shout-out’ ahead of her Eras Tour concerts in Brazil	"The Kansas City Chiefs tight end addressed a running joke that Swift ""put him on the map"" during Friday's episode of his ""New Heights"" podcast."	2	Travis Kelce
Golden Tate Once Angered Brian Kelly By Hitting On Taylor Swift During Practice At Notre Dame In 2009	Golden Tate had a little extra spring in his step when Taylor Swift and Selena Gomez were in town. Notre Dame’s former Biletnikoff Award-winning wide receiver remembers it like it was yesterday. He shot his shot with the international superstar during practic…	2	Travis Kelce
Skip Bayless hopes he’s wrong about ‘fake’ Taylor Swift	Skip Bayless explained why he isn't buying Travis Kelce and Taylor Swift's whirlwind romance.	3	Travis Kelce
Travis Kelce's Old Tweets Reposted by Taylor Swift Fans Ahead of Eagles vs. Chiefs	"Taylor Swift fans are a passionate, unique bunch. Swifties have been digging into the old tweets of Travis Kelce, Swift's current beau, to the point that many…"	2	Travis Kelce
Gigi Hadid Declares Her Stance on Taylor Swift & Travis Kelce Romance	Gigi Hadid is setting the record straight about where she stands on her best friend Taylor Swift’s romance with Chiefs tight end Travis Kelce.	2	Travis Kelce
Taylor Swift fans spot another secret message she sent Travis Kelce during Argentina concert: ‘She’s a mastermind’	"The ""Cruel Summer"" singer sent several special messages to the NFL star during her concert in Buenos Aires, Argentina Saturday night."	1	Travis Kelce
Taylor Swift and Travis Kelce’s Parents Will Reportedly Meet for Upcoming Kansas City Chiefs Game	The NFL star's parents are reportedly set to meet the pop sensation's mom and dad when his team plays against the Philadelphia Eagles on November 20.	2	Travis Kelce
"Joe Alwyn rocks leather look in first public appearance since Taylor Swift, Travis Kelce romance"	"News broke in April that the actor and Swift, who started dating in 2016, had called it quits after the relationship reportedly ""ran its course."""	2	Travis Kelce
Philadelphia radio station ‘forced to punt’ Taylor Swift songs ahead of Chiefs-Eagles game	"A Philadelphia radio station, Q102, announced they would not be playing any Taylor Swift songs until Tuesday night."	2	Travis Kelce
Joy Behar Reveals Why She Doesn’t Want Taylor Swift to End Up With Travis Kelce	The talk show host let loose with a stunning opinion on why Travis and his popstar girlfriend shouldn't be together.	2	Travis Kelce
Swifties Believe Taylor Swift Left Another Secret Message for Travis Kelce at Her Concert	Fans believe that Taylor Swift made yet another subtle nod to 'the guy on the Chiefs' during her Argentina concert on 'The Eras Tour.'	2	Travis Kelce
"TikToker Brianna Chickenfry: I think Taylor Swift, Travis Kelce’s relationship is ‘fake’ and ‘performative’"	"The ""BFFs"" podcast co-host questioned the way the couple behaved at the pop star's Eras Tour show in Buenos Aires, Argentina."	3	Travis Kelce
Taylor Swift fans fall in love with Travis Kelce even more after his old tweets resurface	"As the couple's romance continues to heat up, the Swifties did some deep diving into what the NFL star was like on social media before he wooed the pop star."	2	Travis Kelce
"Taylor Swift, Travis Kelce fans spot pair having secret, intimate moment on date night: ‘My heart jumped out of my chest’"	An up-close video of the pair walking into the Elena restaurant located in the Four Seasons Hotel reveals Kelce's sweet gesture of assurance.	2	Travis Kelce
WATCH: Taylor Swift and Travis Kelce share a kiss after her Buenos Aires concert	Video shows the singer and Chiefs’ tight end embracing each other after her show.	2	Travis Kelce
Taylor Swift and Travis Kelce Make Out After Argentina Concert	"Don't cry for Taylor Swift in Argentina ... she had an amazing show Saturday night, after which she passionately made out with her man. We've seen Trace Kelce and Taylor hold hands, wrap their arms around each other, etc, but this is the first big…"	2	Travis Kelce
Swifties Agree: You ‘Can’t Help but Root’ for Taylor Swift and Travis Kelce	"""We're seeing the romance unfold in real time,"" explains PR expert Beth Booker. ""I think that that's why everyone is so on board with it"""	1	Travis Kelce
Kelsea Ballerini Reacts to Taylor Swift & Travis Kelce’s Concert	"Kelsea Ballerini is rolling out the welcome mat for Taylor Swift and Travis Kelce's PDA era. In fact, the ""Penthouse"" singer quite literally applauded Taylor for running up and planting a kiss on..."	2	Travis Kelce
Hilarie Burton Predicts Taylor Swift & Travis Kelce Engagement by May	"It's a love story, and, baby, Hilarie Burton thinks Taylor Swift may just say yes to Travis Kelce.  After seeing the Kansas City Chiefs player's reaction to the singer's sweet ""Karma"" shout-out at..."	2	Travis Kelce
Is Taylor Swift Engaged to Travis Kelce? 2023 Engagement Rumors Explained	"Taylor Swift and Travis Kelce’s relationship has been making waves this year, with the ‘pair ‘Shake It Off’ singer and Kansas City Chiefs player inevitably becoming one of the most talked-about couples in the celebrity world. As a result, many are wondering: …"	2	Travis Kelce
Taylor Swift and Travis Kelce Gave Us a Little Kiss	"After weeks of increasingly public appearances, Taylor Swift and Travis Kelce finally gave us a little kiss. And in Argentina, no less."	2	Travis Kelce
"How Gigi Hadid Really Feels About Taylor Swift, Travis Kelce's Romance"	Gigi Hadid is in vigilante mode. The model recently shut down a report that claimed she wasn't all too fond of the budding romance between close friend Taylor Swift and NFL star Travis Kelce. In...	2	Travis Kelce
Taylor Swift Runs and Kisses Travis Kelce After Buenos Aires Concert	"Now that's a hard launch. Taylor Swift didn't walk—she ran straight into Travis Kelce's arms after finishing her second Eras tour show in Buenos Aires Nov. 11, meeting the Kansas City Chiefs..."	2	Travis Kelce
Taylor Swift Updates “Karma” Lyrics in Nod to Travis Kelce	"As her Buenos Aires concert ended, the singer ran into the arms of the NFL star and gave him a very public smooch."	2	Travis Kelce
"Fact Check: Joe Alwyn Furiously Reacts to Taylor Swift Dating Travis Kelce, as Videos Claim?"	"Videos that surfaced in November 2023 accurately reported that actor Joe Alwyn ""furiously"" reacted to singer Taylor Swift dating football player Travis Kelce."	2	Travis Kelce
Could Taylor Swift make it to K.C. for Kelce brothers' Super Bowl rematch?	Taylor Swift is currently touring on another continent. Could she make time to jet back to Kansas City for Travis Kelce's big game next week? Here's a breakdown.	2	Travis Kelce
"Taylor Swift embraces Travis Kelce, changes song lyric for him at Argentina concert"	"Taylor Swift changed one of her song lyrics to reference Travis Kelce and embraced the Chiefs tight end during the opening concert of her ""Eras Tour"" international concert series."	2	Travis Kelce
Travis Kelce records Christmas song with brother Jason. Is duet with Taylor Swift next?	"Travis Kelce is not only dating singer Taylor Swift, he's now a singer himself. The Kansas City Chiefs star and his brother Jason have recorded a Christmas duet."	2	Travis Kelce
Taylor Swift-Travis Kelce romance gets more props from Chiefs coach: It's 'a good thing'	"Travis Kelce's coach, the Chiefs' Andy Reid, is still getting those Taylor Swift questions: He's 'just glad' Kelce has 'found somebody he likes.' Ditto Taylor."	1	Travis Kelce
Taylor Swift spotted kissing Travis Kelce! 	"Taylor Swift and Travis Kelce kissing after the Eras Tour in Argentina. pic.twitter.com/FQdTAjDUZ7 — Pop Base (@PopBase) November 12, 2023Time for the internet to have a meltdown. Taylor Swift was seen kissing Travis Kelce after her concert tonight in Buenos…"	2	Travis Kelce
Taylor Swift and Travis Kelce’s Hallmark Movie Performance!	"You have to feel sorry for Travis Kelce on a level. He’s a top NFL player, the leagues best tight end that other top tight ends even say he’s the best tight end to ever play, yet here he is on his days off doing the least masculine thing a man can do, act. Th…"	1	Travis Kelce
"Travis Kelce, the Guy on the Chiefs, Dishes on His Trip to Argentina with Taylor Swift"	Comin’ straight home to her (and making her dad a Chiefs fan while he’s at it).	2	Travis Kelce
Taylor Swift Executes Hall-of-Fame Worthy 10-Yard Dash Into Travis Kelce’s Arms	Let's go to the post-game tape.	2	Travis Kelce
Antoni Porowski Shares First Public Comments on Friend Taylor Swift Dating Travis Kelce	"Antoni Porowski is speaking out about his friend Taylor Swift‘s new romance with Travis Kelce! The 39-year-old Queer Eye star joined the 33-year-old superstar at a Kansas Chiefs game last month to cheer on the football star. Now, Antoni is revealing what he t…"	2	Travis Kelce
Travis Kelce Reacts to Taylor Swift Changing the Lyrics of 'Karma' to Reference Him	"Travis Kelce is definitely feeling surprised! The 34-year-old Kansas City Chiefs tight end attended girlfriend Taylor Swift‘s Eras Tour stop in Buenos Aires’ Estadio River Plate in Argentina on Saturday (November 11), where she changed the lyrics to her song,…"	2	Travis Kelce
Hilarie Burton Predicts Taylor Swift & Travis Kelce Will Be 'Engaged by May'	"Hilarie Burton is making a big prediction about Taylor Swift and Travis Kelce! On Saturday night (November 11), the 34-year-old pro football player attended his first Eras Tour show as the 33-year-old “Blank Space” singer’s boyfriend. During the show, Taylor …"	2	Travis Kelce
Report: Travis Kelce to Visit Taylor Swift in Argentina amid Chiefs' Bye Week	"Travis Kelce is reportedly traveling to Argentina during the Kansas City Chiefs' bye week, and for good reason. Kelce will be traveling to the South American…"	2	Travis Kelce
Travis Kelce reportedly will travel to Argentina to visit Taylor Swift	"Travis Kelce hinted Wednesday that his bye-week plans might include a visit to Taylor Swift. Speaking with his brother, Jason, on their New Heights podcast, Kelce said he might go somewhere ""closer to the equator."" Viewed next to reports last month that he wo…"	2	Travis Kelce
Taylor Swift and Travis Kelce Draw Cheers During Date in Buenos Aires	"Taylor Swift and Travis Kelce's love story has gone global—and received a round of applause. On Nov. 10, the couple reunited in Buenos Aires, where the pop star is set to perform the following day..."	2	Travis Kelce
Travis Kelce’s Plans to Cheer on Taylor Swift at Eras Tour Revealed	"Travis Kelce cheering on Taylor Swift never goes out of style. And the tight end is officially continuing their love story in South America, as he's headed to Argentina to support the pop star..."	2	Travis Kelce
Taylor Swift and Travis Kelce Reunite in Argentina	"After Swift's Buenos Aires concert was canceled due to weather, the tight end dined with the singer and her dad."	2	Travis Kelce
"TMZ: Travis Kelce, Taylor Swift Dating 'Overwhelming' for Jason, Mom Donna and Family"	"Kansas City Chiefs tight end Travis Kelce's relationship with Taylor Swift has been an adjustment for the entire Kelce family, according to TMZ Sports.…"	2	Travis Kelce
A Swiftie’s Halloween Costume Joked That Taylor Swift Put Travis Kelce on the Map — He Loved It	"""You get a round of applause for that one. I enjoyed that,"" the Kansas City Chief's player said after watching a TikTok one fan made showing off her clever costume"	2	Travis Kelce
Travis Kelce Reacts to Costumes Inspired by Taylor Swift Romance	"Travis Kelce has mad love for what some people have done for Halloween to pay homage to him and Taylor Swift. In fact, the Kansas City Chiefs tight end and his brother Jason Kelce critiqued fans'..."	2	Travis Kelce
Taylor Swift and Travis Kelce Have the Same Taste In Rolexes	The newly-formed power couple are a match made in horological heaven. Both Taylor Swift and Travis Kelce have a penchant for the iconic Rolex Day-Date.	2	Travis Kelce
What We’re All Getting Wrong About Travis Kelce	"Photo Illustration by Erin O'Flynn/The Daily Beast/Getty Images Being Taylor Swift’s boyfriend in no way guarantees that the world will love you as much as she does. Just ask The 1975 frontman and Swift ex Matty Healy, whose edgelord comments about future Sw…"	2	Travis Kelce
Taylor Swift Gives Her Fans Another Puzzle to Crack	The pop star’s relationship with an NFL player gives fans a peculiar form of gratification.	2	Travis Kelce
"Travis Kelce opens up about dating Taylor Swift and navigating public scrutiny, calls girlfriend ‘genius’"	"In a recent interview, Travis Kelce, the tight end for the Kansas City Chiefs, opened up about the difficulties of being in the public eye following the revelation of his relationship with pop icon Taylor Swift."	1	Travis Kelce
Rafael Nadal could cross paths with Taylor Swift next year thanks to Travis Kelce	"Kansas City Chiefs tight end Travis Kelce and popstar Taylor Swift have been the hottest story in sports since they started dating last month, and now tennis fans are joining the f"	2	Travis Kelce
Travis Kelce and Taylor Swift's reportedly planning months ahead in a 'long-term' relationship	Every single Swiftie has been hoping for Taylor Swift to be on the right track with Travis Kelce this time. The popstar&apos;s previous relationships haven&apos;t been what her fan	2	Travis Kelce
Travis Kelce’s Style Evolution Proves He's Got (Fashion) Game	"A look back at Travis Kelce's best (and worst) fashion, hair, and overall style looks from 2012 to his most recent dates with girlfriend Taylor Swift."	2	Travis Kelce
How Travis Kelce spent Thanksgiving without Taylor Swift	"While Swift was once rumored to be returning home to the US for the holiday, she seemingly changed her mind and stayed in Brazil for her next Eras Tour show."	2	Travis Kelce
Jason Kelce’s Wife Kylie Addresses Rumors That She’s Feuding With Taylor Swift: ‘You’re Reaching’	Kylie shared a video breaking down the moment when she said in an interview that the ‘attention’ isn’t her ‘cup of tea.’	2	Travis Kelce
Travis Kelce without Taylor Swift: How did the Kansas City Chiefs' star celebrate Thanksgiving?	Travis Kelce spent Thanksgiving 2023 by cruising around Kansas City in his Rolls-Royce whilst Taylor Swift was in Brazil for her &quot;Eras Tour&quot; in Sao Paulo.  He likely bou	2	Travis Kelce
Travis Kelce labelled 'mommy's boy' after fans rediscover footage of him making dinner request during game	"Travis Kelce has been in the news a lot of as late. His blossoming relationship with Taylor Swift has seen his profile grow exponentially, with even brother Jason recognizing that"	2	Travis Kelce
Packers fans reactions after Jonathan Owens' first touchdown: Being married to Simone Biles is way cooler than dating Taylor Swift	"The Green Bay Packers surprised many by defeating the Detroit Lions on Thanksgiving, showcasing their potential future with Aaron Rodgers&apos; successor quarterback Jordan Love."	3	Travis Kelce
Lonely holiday! Travis Kelce spotted spending Thanksgiving without Taylor Swift – singing to himself	"While his girlfriend Taylor Swift is more than 4,500 miles away in Brazil, Travis Kelce has been spotted spending his Thanksgiving alone singing to himself."	2	Travis Kelce
Simone Biles celebrates husband Jonathan Owens’ first NFL touchdown in Green Bay Packers win	"Originally Published: 24 NOV 23 07:24 ETBy George Ramsay, CNN(CNN) — Take a back seat, Taylor Swift and Travis Kelce. There’s another power couple in the NFL.Olympic champion gymnast Simone Biles could hardly contain her excitement as her husband, Jonathan Ow…"	2	Travis Kelce
A Thanksgiving guest's guide to Taylor Swift and Travis Kelce	Don't be the only one at the table who's behind on the season's hottest romance plot.	2	Travis Kelce
Travis Kelce Driving Solo As He Spends Thanksgiving Away From Taylor Swift	"Travis Kelce is planning to spend Christmas with Taylor Swift, but in the meantime he's gotta get through another holiday solo ... and that means some alone time on the road. The Kansas City Chiefs star tight end is spending his Thanksgiving by…"	2	Travis Kelce
Kylie Kelce Responds to Negative Headline About Her & Taylor Swift	"Kylie Kelce is shutting down rumors of bad blood between her and Taylor Swift. Kylie is married to Jason Kelce, the Philadelphia Eagles player who is the brother of Kansas City Chiefs star Travis Kelce, Taylor‘s boyfriend. The Kelce family has been getting a …"	2	Travis Kelce
Kylie Kelce Fact Checks Taylor Swift Headline in a Truly Iconic TikTok	This is now a Kylie Kelce fan account.	2	Travis Kelce
"Taylor Swift, Travis Kelce's Inner Circle's Thoughts on Their Romance"	"Taylor Swift and Travis Kelce’s inner circle haven’t been afraid to let their opinions on the pair’s romance be known. “Friends close to Taylor and Travis think they make an amazing power couple, and they couldn’t be happier for them,” a source exclusively to…"	2	Travis Kelce
Taylor Swift and Travis Kelce Are Heading to Nashville and Going on a Romantic Getaway	"""They’re trying to be as much like a regular couple as possible."""	2	Travis Kelce
Olive Garden Sends Message to Travis Kelce	"Italian restaurant chain has joined the Kelce and Taylor Swift train by replying to old posts by Kelce that called its food ""shmackin."""	2	Travis Kelce
NFL boss Roger Goodell thinks ‘it’s great’ Taylor Swift brings ‘attention’ to league with Travis Kelce romance	"The commissioner said it's ""great in an of itself"" that the couple ""seem to be enjoying their relationship"" -- but the new viewers are also a bonus."	1	Travis Kelce
"Travis Kelce’s mom, Donna, shares family’s Thanksgiving plans as Taylor Swift remains in Brazil"	"While Travis plans to ""feast ... on KFC"" for the holiday, brother Jason Kelce invited him to ""make a quick trip"" to Pennsylvania to celebrate."	2	Travis Kelce
Chris Russo goes off on Travis Kelce visiting Taylor Swift in Argentina on ‘First Take’	Chris Russo seems to think Travis Kelce's priorities were in the wrong place.	2	Travis Kelce
"While Taylor Swift is still in Brazil, Travis Kelce's mother, Donna, discusses the family's Thanksgiving preparations"	Donna Kelce shares her plans for Thanksgiving whereas Travice will be spending his Thanksgiving alone and Taylor Swift will be in Brazil for her performances and upcoming tour.	2	Travis Kelce
Is Travis Kelce Traveling to See Taylor Swift's Tour? He Says...	Travis Kelce is keeping this play close to his chest. The Kansas City Chiefs player teased his plans to see Taylor Swift kick off the South American leg of her Eras Tour—but isn't confirming his...	2	Travis Kelce
Kylie Kelce slams headline about her and Taylor Swift: ‘You’re reaching’	Kylie Kelce posted on TikTok to address a headline about her avoiding Taylor Swift's spotlight.	2	Travis Kelce
Olive Garden sends message to Travis Kelce	"Restaurant chain Olive Garden says it is all about making its guests feel like family, and it has now extended its family invite to Kansas City Chiefs tight end Travis Kelce. Kelce needs to eat a lot of calories as an athlete, and thanks to the help of some o…"	2	Travis Kelce
"Kylie Kelce defends herself over exaggerated quotes about Taylor Swift, and Swifties love it"	"Jason Kelce&apos;s wife, Kylie Kelce, opted not to be in the suite for the &quot;Monday Night Football&quot; game between the Philadelphia Eagles and her brother-in-law Travis Kelc"	2	Travis Kelce
Olympic Legend Simone Biles Hypes Husband Jonathan Owens for Packers' TD vs. Lions	"While Taylor Swift and Travis Kelce get a lot of the shine, they aren't the only celebrity couple in the NFL. Superstar Olympic gymnast Simone Biles has been…"	2	Travis Kelce
Chris Russo hit out at Travis Kelce over trip to Argentina to see Taylor Swift	Sports commentator Chris Russo has criticized Kansas City Chiefs&apos; tight end Travis Kelce for his recent trip to Argentina to see Taylor Swift perform during the bye week.  Ru	2	Travis Kelce
Travis Kelce accused of 'hiding something' about his relationship with Taylor Swift	"Kansas City Chiefs tight end Travis Kelce, known for his high-profile relationship with Taylor Swift, is considered one of the most prominent NFL players this season.  Despite bei"	2	Travis Kelce
Jason Sudeikis Weighs In On Taylor Swift & Travis Kelce’s Relationship	"Jason Sudeikis is showing gratitude to Taylor Swift—and Travis Kelce—this Thanksgiving. After all, the Ted Lasso star was thrilled to be able to catch the Grammy winner's Eras Tour during its..."	2	Travis Kelce
Taylor Swift Fans Dug Up Travis Kelce’s Old ‘Himbo’ Tweets	"Taylor Swift’s romance with Travis Kelce sparked an internet investigation from the Swifties, who discovered that the NFL star was a “himbo.”"	2	Travis Kelce
"NFL's Roger Goodell: Travis Kelce, Taylor Swift's Relationship 'Great for the League'"	NFL commissioner Roger Goodell is very happy to see Taylor Swift around the league thanks to her relationship with Kansas City Chiefs tight end Travis Kelce.…	1	Travis Kelce
NFL Commissioner Roger Goodell Calls Taylor Swift-Travis Kelce Romance “Great For The League”	"Taylor Swift is good for the NFL. And that comes from someone who should know. NFL Commissioner Roger Goodell appeared on CBS Mornings today to talk about all things football heading into the Thanksgiving weekend, and the subject inevitably turned to Swift an…"	1	Travis Kelce
Travis Kelce Reveals If He's Having Thanksgiving With Taylor Swift	"Travis Kelce's champagne problem? He'll have to tolerate Thanksgiving without his lover. The Kansas City Chiefs player revealed that he's planning to spend the Nov. 23 holiday alone in Missouri,..."	2	Travis Kelce
Jason Kelce’s Wife Kylie Sets Record Straight on Taylor Swift Comment	Jason Kelce’s wife Kylie has a message in a bottle for critics who are reading too much into her recent comments about the attention Taylor Swift and Travis Kelce's romance has brought on her family.	2	Travis Kelce
Where on Earth Is Taylor Swift Spending Thanksgiving?	"Just when you thought there was nothing left to learn about Taylor Swift and Travis Kelce, tabloids are wildly speculating: What will they do for the holidays?"	2	Travis Kelce
Travis and Jason Kelce Thank Taylor Swift & Fans For This Reason	"Travis Kelce and Jason Kelce know all too well how their song became a hit. After the brothers' holiday song ""Fairytale of Philadelphia"" scored the first spot on some charts following its Nov. 15..."	1	Travis Kelce
Travis Kelce Confirms He & Taylor Swift Are Not Spending Thanksgiving Together Amid Her Tour	"The singer was supposed to have a short break in her 'Eras Tour' during the holiday, but that may have changed."	2	Travis Kelce
Travis Kelce’s ‘Hallarious’ Old Tweets Were His ‘Diary’	Travis Kelce has described his endearing old tweets as his ‘diary.’ So we sorted his posts from the vault as Taylor Swift diaries (a.k.a. her albums and eras).	2	Travis Kelce
"NFL commissioner Roger Goodell opens up about league's popularity, Taylor Swift's impact"	"""CBS Mornings"" co-host Nate Burleson speaks with NFL commissioner Roger Goodell about the surge in the league's popularity, Super Bowl 2024, player safety, Taylor Swift, Travis Kelce and much more."	2	Travis Kelce
Travis Kelce Reveals His Thanksgiving Plans While Girlfriend Taylor Swift Is in Brazil	"Jason Kelce and Travis Kelce are talking Thanksgiving! The Kelce brothers returned with a new episode of their weekly podcast, New Heights with Jason and Travis Kelce, and revealed their holiday plans. During the podcast, the two revealed that they will not b…"	2	Travis Kelce
Taylor Swift Has Been Leaning on Travis Kelce Following Fan's Tragic Death in Brazil	"“He’s been a huge support system for her right now."""	2	Travis Kelce
Ariana Madix Thinks Taylor Swift Is 'So Happy and Free' Dating Travis Kelce	"Ariana Madix is a self-proclaimed Taylor Swift fan — and she wholeheartedly approves of the pop star’s romance with Travis Kelce. “I think she seems so happy and free,” Madix, 38, told Extra on Tuesday, November 21, when asked about Swift’s relationship. “I l…"	2	Travis Kelce
Taylor Swift and Travis Kelce Are ‘in Love’: Inside Their Holiday Plans	"It’s beginning to look a lot like a fairy-tale holiday season for Taylor Swift and Travis Kelce. The couple have been moving full speed ahead, with Kelce attending Swift’s November 11 concert in Buenos Aires, Argentina, and both sides meeting each other’s fam…"	2	Travis Kelce
Garcia Twins Say Travis Kelce ‘Throws’ Taylor Swift Around ‘In the Bedroom’	"Nikki Garcia and Brie Garcia are huge supporters of Taylor Swift and Travis Kelce. “She’s so in love,” Nikki, 40, told the Daily Mail in a Wednesday, November 22, TikTok video. “It’s because she finally has a real man … He grabs her and throws her around.” Br…"	2	Travis Kelce
Taylor Swift Fans Dug Up Travis Kelce’s Old ‘Himbo’ Tweets	"Taylor Swift’s boyfriend is not a role for the faint-hearted, as Travis Kelce recently discovered. The pop star has ascended into a one-woman franchise that can turn tides of the box office, even the voting booth; a gargantuan swarm of “Swifties” are always r…"	2	Travis Kelce
"Jason, Travis Kelce thank Taylor Swift fans for No. 1 song"	"Jason and Travis Kelce might have a No. 1 song together, but they are well aware of who is responsible for the success of ""Fairytale of Philadelphia."" Score yet another win for Taylor Swift's legion of fans, nicknamed the Swifties. On Wednesday's episode of t…"	2	Travis Kelce
Jason Kelce’s Wife Not Interested In Being In The Spotlight Amid Taylor Swift/Travis Kelce Media Frenzy	"Jason Kelce’s wife, Kylie, is not looking to be featured in any of the Kelce/Taylor Swift media frenzy. For the past two months, the Kelce family has been in the spotlight since Travis began dating Swift. While participating in a field hockey clinic for child…"	2	Travis Kelce
Jason and Travis Kelce Thank Taylor Swift & Swifties For Sending Christmas Single to No. 1 on iTunes	"Travis Kelce is getting a taste of what Taylor Swift feels like when she tops the charts, and it’s all thanks to the Swifties. Related 10 First-Timers on Billboard’s Charts This Week: Travis Kelce, Jason Kelce, The Red Clay Strays… 11/22/2023 On the latest ep…"	1	Travis Kelce
Travis Kelce's Old Tweet Inspires Chipotle to Change Its Name	"The company even modified the sign at a Kansas City Chipotle. Chipotle is capitalizing on a marketing opportunity thanks to Travis Kelce's old resurfaced tweets. In the wake of pandemonium over the NFL star's budding relationship with Taylor Swift, Swifties a…"	2	Travis Kelce
"Jason, Travis Kelce Thank Taylor Swift Fans for No. 1 Song"	Jason Kelce raised over $1 million for Philadelphia charities with his debut Christmas album last year.	1	Travis Kelce
Travis Kelce reveals Thanksgiving plans as Taylor Swift remains in Brazil for holiday	"""I'll be feasting on KFC because I won't have anybody here,"" the two-time Super Bowl champ explained."	2	Travis Kelce
Travis and Jason Kelce thank Taylor Swift and Swifties for getting their Christmas song to No. 1	"On the New Heights podcast, Travis Kelce and Jason thanked Taylor Swift and Swift fans."	1	Travis Kelce
Here's Why Taylor Swift Is Seemingly Staying in Brazil for Thanksgiving	"There have been reports swirling that Taylor Swift was planning on spending Thanksgiving with her new boyfriend Travis Kelce, but that likely will not happen this year. It’s believed that Taylor will be spending the holiday in Brazil this week amid her concer…"	2	Travis Kelce
Travis And Jason Kelce Score Their First Billboard Chart Hit	"Travis Kelce has followed his girlfriend Taylor Swift by charting his first hit on the Billboard charts, ""Fairytale of Philadelphia,"" with his brother Jason Kelce."	2	Travis Kelce
Jason Sudeikis Calls Taylor Swift Kansas City’s ‘Adopted Daughter’	"Jason Sudeikis is grateful Taylor Swift has been spending so much time in his hometown of Kansas City amid her romance with Travis Kelce. “I was thankful to Taylor, just hanging out, coming to do two nights of [Eras Tour] shows here,” Sudeikis, 48, told The H…"	1	Travis Kelce
"Fact Check: Travis Kelce Responds to Taylor Swift Engagement Rumors, as Videos Claim?"	Videos that surfaced in November 2023 accurately reported that Travis Kelce publicly responded to Taylor Swift engagement rumors.	2	Travis Kelce
"What Travis Kelce, Patrick Mahomes, more are saying about Taylor Swift"	Several people close to Travis Kelce expressed their thoughts on his relationship with Taylor Swift ahead of Monday's Chiefs-Eagles tilt.	2	Travis Kelce
Is Taylor Swift at the Chiefs Game? Why She Skipped Travis Kelce’s Game Against The Eagles	Taylor Swift did not attend the Kansas City Chiefs-Philadelphia Eagles game on November 20 because of recent developments with her 'Eras Tour' in Brazil.	2	Travis Kelce
Eagles troll Chiefs with Taylor Swift reference after big win	"The team posted a picture of a green friendship bracelet that read ""Eagles win"" on Instagram​ following their 21-17 victory on Monday."	2	Travis Kelce
Everything Taylor Swift's Friends Have Said About Travis Kelce & Their New Relationship	"Taylor Swift‘s new love story with Travis Kelce has a lot of people talking, including the “Lavender Haze” singer’s friends! Taylor, 33, has been dating Travis, 34, since September. Since then, Taylor has attended several of the NFL player’s Kansas City Chief…"	2	Travis Kelce
"Donna Kelce ""Feels Bad"" About That Awkward Taylor Swift Interview"	"Apparently she ""still berates herself for how she handled"" it. :("	2	Travis Kelce
Travis Kelce's Mom Regrets Comments About Taylor Swift; Travis Called Her After That 'Today Show' Interview	"Travis Kelce‘s mom really regrets her initial comments about Taylor Swift. During an interview on The Today Show in early October, Donna Kelce was asked for her thoughts on the 33-year-old “Cruel Summer” singer after meeting her for the first time at one of t…"	2	Travis Kelce
Travis Kelce's Mom Regrets The Way She Handled A Taylor Swift Question	"Donna Kelce, the mother of the Kansas City Chiefs player, previously said on ""Today"" that meeting the pop star was ""OK."""	2	Travis Kelce
"Cara Delevingne Says Taylor Swift, Travis Kelce’s Romance Is 'Different'"	"Taylor Swift’s love for Travis Kelce is glowing in the dark, and pal Cara Delevingne is fully supportive of the budding romance. “I’m so, so happy for her,” Delevingne, 31, told E! News on Saturday, November 18, while at the 2023 Las Vegas Grand Prix. “I’m al…"	1	Travis Kelce
Why Taylor Swift Isn't at the Chiefs vs. Eagles Game Tonight	"Taylor was initially ""trying to manage going to the game."""	2	Travis Kelce
Travis Kelce Spills on ‘Mind-Blowing’ Taylor Swift Romance	"Gotham/GC Images Kansas City Chiefs tight end Travis Kelce—who at this point is as much America’s Sweetheart as his new girlfriend, Taylor Swift—served the Swifties well on Monday with a revealing Wall Street Journal cover story (and an accompanying, super s…"	2	Travis Kelce
"Taylor Swift, Travis Kelce Full Steam Ahead With Holiday Plans, Talking Christmas"	Taylor Swift and Travis Kelce are looking to get into the Christmas spirit as a couple ... we're told they're moving forward with plans to be together for the holidays. Sources close to the couple tell TMZ ... Taylor and Travis are trying to work…	2	Travis Kelce
"Travis Kelce Praises 'Genius' Taylor Swift, She's 'F***ing Mind-Blowing'"	Travis Kelce's love for Taylor Swift is much deeper than her looks and musical talent ... the NFL superstar says he's fascinated by her brain and learning new things from her every day. The Kansas City Chiefs tight end opened up on his relationship…	1	Travis Kelce
Are Travis Kelce & Taylor Swift Able to Celebrate Thanksgiving Together?	"Travis Kelce‘s girlfriend Taylor Swift can’t make it to his Monday Night Football game tonight (November 20) against the Philadelphia Eagles because she had an unexpected concert to perform after her Eras tour postponement over the weekend. However, fans are …"	2	Travis Kelce
"Cara Delevingne Says Taylor Swift-Travis Kelce Romance Is ""Different"""	"Everything has changed since Taylor Swift started dating Travis Kelce. After all, the pop superstar's friend Cara Delevingne believes her budding romance with the Kansas City Chiefs tight end is..."	2	Travis Kelce
Taylor Swift's Music Is Temporarily Banned From Philly Radio Station	This radio station won't be filling in the blank spaces with Taylor Swift hits this weekend.  A southeast Pennsylvania radio station announced that the pop superstar's music is temporarily...	3	Travis Kelce
Travis Kelce Reveals How His Love Story With Taylor Swift Really Began	"Travis Kelce is filling in the blank spaces of his relationship with Taylor Swift. While the Kansas City Chiefs tight end and the Grammy winner have taken their romance public in recent months,..."	2	Travis Kelce
Taylor Swift won't be in attendance to watch Kelce brothers at Chiefs-Eagles	"Taylor Swift won't be in Kansas City when Travis Kelce takes on his brother, Jason, in Monday's Super Bowl LVII rematch."	2	Travis Kelce
Travis Kelce says he’s ‘never dated’ anyone like Taylor Swift: ‘I’m not running away from any of it’	Travis Kelce is finally revealing what it’s like to be dating one of the biggest pop stars in the world: Taylor Swift.	2	Travis Kelce
Taylor Swift Changes Plans and Skipping Monday's Chiefs Game	The singer had been expected to cheer boyfriend Travis Kelce on in the matchup between the Kansas City Chiefs and the Philadelphia Eagles.	2	Travis Kelce
Report: Taylor Swift’s Parents Dating Travis Kelce’s Parents	"NASHVILLE, TN—In the latest relationship development that fans of the power couple called “adorable,” sources confirmed Thursday that Taylor Swift and Travis Kelce’s parents were dating. “Andrea, Scott, Donna, and Ed are all absolutely smitten with each other…"	2	Travis Kelce
Philly radio station 'punts' Swift from weekend playlist ahead of Chiefs-Eagles	"Taylor Swift grew up an Eagles fan, but her relationship with Chiefs tight end Travis Kelce is causing one Philadelphia radio station to take no chances."	3	Travis Kelce
Travis Kelce says Taylor Swift's lyric change at Argentina concert 'shocked' him	"Taylor Swift referenced Travis Kelce in a song and embraced the Chiefs star during her ""Eras Tour"" international concert series."	2	Travis Kelce
"Report: Travis Kelce, Taylor Swift's Parents Expected to Meet at Eagles vs. Chiefs"	Travis Kelce and Taylor Swift appear to be taking the next step in their relationship. The parents of the Chiefs tight end and world-renowned…	2	Travis Kelce
Taylor Swift’s ‘Karma’ Streams Rise After Her Nod to Travis Kelce	Streams and sales for the Midnights hit shot up after the pop star changed a lyric referencing her Kansas City Chiefs boyfriend during Eras Tour stop in Argentina	1	Travis Kelce
Why Travis Kelce Was MIA From Taylor Swift’s Argentina Eras Tour Stop	"They were jet set like Bonnie and Clyde... But not quite yet. After Travis Kelce hinted that he might be joining girlfriend Taylor Swift in Argentina for her Eras World Tour stops, Swifties..."	2	Travis Kelce