Combined	Category
taylor swift fan dy rio de janeiro concert heat wave pop star stopped show twice ask venue hand water time taking upon throw bottle fan	Dead Fan
taylor swift mourns fan died rio concert taylor swift international leg era tour friday night performed rio de janeiro brazil nilton santos stadium many fan fell ill due heatwave heat index fahrenheit one concertgoer died c	Dead Fan
taylor swift mourns death fan brazil concert taylor swift grieving death concertgoer brazil saying tragedy left devastated shattered heart pop star took instagram posted heartfelt letter friday night era tour show	Dead Fan
taylor swift devastated fan dy era tour show brazil cant believe im writing word shattered heart say lost fan earlier tonight show swift wrote statement	Dead Fan
taylor swift fan dy rio concert fan complain high temp lack water yearold taylor swift fan died singer era tour concert rio de janeiro show organizer brazil said statement saturday morning ana clara benevides machado attended paramedic show taken hospit	Dead Fan
taylor swift shattered loss fan front row concert rio taylor swift penned emotional tribute young female fan died era show rio de janeiro friday evening instagram account solo superstar wrote devastation loss yearold woman named ana	Dead Fan
taylor swift devastated fan dy brazil concert taylor swift mourning death fan died era tour concert rio de janeiro nov ana clara benevides machado rushed hospital treatment falling ill	Dead Fan
fan dy taylor swift show sweltering rio de janeiro young brazilian fan u singer taylor swift died rio de janeiro friday night falling ill inside superstar sweltering concert venue amid recordbreaking heatwave across large swathe brazil ana clara benevides became unwell	Dead Fan
taylor swift fan dy cardiac arrest attending rio era tour buda mendestas late friday night taylor swift made devastating announcement via instagram story fan attendance first date night era tour engagement rio de janeiro brazil passed away cant believe im writing	Dead Fan
taylor swift mourns fan died brazil concert cant believe im writing word shattered heart say lost fan earlier tonight show swift wrote handwritten statement swift show coincided heat wave brazil folha reporting feel	Dead Fan
taylor swift devastated death fan concert rio de janeiro yearold woman named went cardiac arrest attending swift era tour show taylor swift devastated death fan concert rio de janeiro scoop harrison	Dead Fan
fan taylor swift concert dy amid rio de janeiro recordbreaking heat wave year old student died swift concert heat index reached reported degree fan permitted bring water stadium	Dead Fan
taylor swift mourns fan died brazil concert taylor swift shared statement mourning fan died era tour stop rio de janeiro brazil yearold fan reportedly died hospital fainting venue amid extreme heat wave	Dead Fan
feel overwhelmed grief taylor swift give emotional tribute fallen fan following death yearold woman concert brazil singer penned heartfelt message instagram	Dead Fan
taylor swift say fan died brazil concert post heartfelt message taylor swift honoring swiftie sadly passed away concert following completion first era tour performance rio de janeiro brazil friday november taylor posted message instagram story acknowledging fan	Dead Fan
taylor swift fan dy rio concert amid complaint excessive heat swift posted instagram story news fan death writing shattered heart	Dead Fan
devastated taylor swift speaks fan died ahead brazil concert singer made announcement rio de janeiro show amid dangerous heat wave brazil week	Dead Fan
taylor swift pen emotional message wake tragic concert goer death taylor swift devastated reacts awful shocking death fan attended concert brazil taylor swift pen emotional message wake tragic concert goer death originally published hollywood gossip	Dead Fan
taylor swift release statement fan tragically dy waiting brazil show im going able speak stage feel overwhelmed grief even try talk	Dead Fan
taylor swift fan dy heat era tour brazil tonight era tour brazil rio taylor performed fan named ana passed away heatstroke degree fan allowed bring water stadium taylor team passed water taylor directed water	Dead Fan
overwhelmed grief taylor swift fan dy cardiac arrest concert yearold fan died cardiac arrest friday night attending taylor swift concert brazil	Dead Fan
taylor swift overwhelmed grief brazilian fan died preconcert taylor swift spoke one brazilian fan died shortly era tour concert cant believe im writing word shattered heart say lost fan earlier tonight show swift wrote via instagra	Dead Fan
taylor swift fan dy rio concert fan complain high temperature lack water concertgoers complained allowed take water nilton santos olympic stadium despite soaring temperature federal authority announced free water would made available future concert	Dead Fan
taylor swift mourns fan died friday night brazil concert feel overwhelmed grief incredibly beautiful far young singer say heartfelt message instagram post taylor swift mourns fan died friday night brazil concert feel overwhelmed grief appeared first thewrap	Dead Fan
taylor swift fan dy cardiac arrest shortly fainting rio concert degree weather taylor swift stopped show one point pleaded stadium staff provide water concertgoers	Dead Fan
fan dy taylor swift concert rio amid heat complaint water yearold taylor swift fan died singer era tour concert rio de janeiro friday night according statement show organizer brazil fan politician reacted news outrage cause death ana c	Dead Fan
taylor swift mourns fan died brazil era tour show taylor swift posted typed instagram storywritten branded scriptabout devastation death fan era tour show brazil friday cant believe im writing word read	Dead Fan
taylor swift devastated fan reportedly dy cardiac arrest brazil concert singer shared heartbreaking message concertgoer reportedly passed away went stage rio de janeiro	Dead Fan
taylor swift fan dy show brazil superstar say taylor swift said saturday devastated death fan show brazil friday night	Dead Fan
taylor swift confirms death fan era tour show hot humid evening led dehydration many recordsetting era tour source joy million across united state international city taylor swift shared charttopping music world tragedy struck friday rio de janeiro brazil	Dead Fan
taylor swift devastated fan dy ahead brazil concert overwhelmed grief taylor swift said overwhelmed grief fan died ahead era tour concert brazil friday night antihero hitmaker revealed tragedy mourned fan death performed first three night rio de j	Dead Fan
taylor swift say hattered heart yearold fan dy era tour concert rio de janeiro cause death announced medium reported fan allowed take water stadium despite soaring temperature	Dead Fan
taylor swift say overwhelmed grief fan dy attending brazil era tour show cant believe im writing word shattered heart say lost fan earlier tonight show wrote	Dead Fan
taylor swift seems back tragic death fan rio de janeiro taylor swift back friday concert brazil mourning death fan one week ago t hit stage perform front packed crowd paulo last evening appeared great spirit	Dead Fan
police investigation underway taylor swift fan death brazil brazilian police taking next step recent death taylor swift fan nbc news reported official launched investigation timefun company responsible organizing swift era tour stop rio de janeiro swift perform	Dead Fan
et confirms taylor swift reached ana clara benevides machado family et learned taylor swift team reached ana clara benevides machado family following death pictwittercomabyjhczjl entertainment tonight etnow november et confirmed taylor swift team reached	Dead Fan
rio police investigate taylor swift concert organizer fan death rio police investigate taylor swift concert organizer fan death	Dead Fan
climate change made taylor swift brazil concert dangerous death taylor swift fan midst heat wave brazil another sign enough adapt rapidly changing climate	Dead Fan
taylor swift rio concert venue admitted could done keep people safe extreme heat ana clara benevides laid rest tuesday swifties crowdfunded money needed family fly body homeview entire post	Dead Fan
organizer taylor swift brazilian era tour date investigated following fan death getty image ana clara benevides machado died november	Dead Fan
news could taken alternative measure brazilian company admit fault taylor swift fan death chief executive company organising taylor swift tour date brazil apologised fan died searing heat wave superstar rio de janeiro show	Dead Fan
taylor swift brazil concert trigger police probe fan dy stadium police brazil reportedly opened probe organizer last friday oppressively hot taylor swift concert left one fan dead pop star gasping air rep rio de janiero civil police department said	Dead Fan
taylor swift stop crowd paying tribute late fan ana family denies t tf reached followup post starting better note ana clara benevide mother thanked everyone donated money pay body transportation cost see video taylor swift fan crowdfunded order help ana benevides family	Dead Fan
brazil authority investigate organizer taylor swift concert following fan death ana clara benevides died falling ill friday concert rio de janeiro city experienced record temperature	Dead Fan
taylor swift concert organizer investigation fan dy singer rio de janeiro show report taylor swift fan ana clara benevides machado passed away friday november singer rio de janeiro brazil concert due record high temperature	Dead Fan
brazilian official investigating company behind taylor swift show rio de janeiro fan death paulo police rio de janeiro said wednesday investigation launched timefun brazilian company organized taylor swift show city day fan died others reported unbearable condition attending	Dead Fan
brazilian official investigating company behind taylor swift show rio de janeiro fan death police rio de janeiro said investigation launched timefun brazilian company organized taylor swift show city day fan died era tour extreme heat wave	Dead Fan
taylor swift concert organizer apologizes rio fan death chief executive company organizing taylor swift tour date brazil apologized thursday fan died searing heat wave pop superstar rio de janeiro show organizer faced criticism fan said forbidden	Dead Fan
police brazil launch investigation taylor swift fan dy concert event organizer called testify step underway investigate fact rep civil police department brazil told nbc news	Dead Fan
brazilian official investigating company behind taylor swift show rio de janeiro fan death police rio de janeiro said nov investigation launched timefun brazilian company organized taylor swift show city day fan died others reported unbearable condition attending era tou	Dead Fan
family taylor swift fan died rio concert attends singer third era tour show paolo ana clara benevides died ahead swift show nov going cardiac arrest amid extreme temperature rio de janeiro brazil	Dead Fan
swifties raise money family fan died taylor swift concert ana clara benevides died attending singer show rio de janeiro brazil	Dead Fan
swifties raise money family fan died brazil era tour stop taylor swift fan brazil helped raise money transport body ana clara benevides machado died swift concert november rio de janeiro brazilian state mato grosso sul fan posted video reportedly benev	Dead Fan
extreme heat led taylor swift fan death brazil could prevented era rising heat wave expert weigh plan concert large event safely	Dead Fan
taylor swift gift vip experience family fan died brazil concert family ana clara benevides taylor swift fan died rio de janeiro concert earlier month treated vip experience popstaraposs sao paulo sh	Dead Fan
death taylor swift concert event organizer deal heat death yearold woman brazil dw look organizer large event handle extreme heat supply water	Dead Fan
mom taylor swift fan died brazil concert get emotional swifties help return daughter body blasting show organizer ana clara benevides died becoming ill swift friday concert rio	Dead Fan
slatest nov trump lawyer argued might able reveal name address juror story fan death taylor swift show supreme court voting right act secret perfect mashed potato	Dead Fan
two fan died following taylor swift trio show rio de janeiro taylor swift currently south american leg era tour three consecutive date estdio nilton santos rio de janeiro brazil marred intense heat pickpocketing	Dead Fan
fan died taylor swift show got confusing heat blazing floor metal anything else could done	Dead Fan
taylor swift fan dy rio de janeiro leg era tour yearold ana clara benevides died caridac arrest attending taylor swift show rio nilton santos stadium november swift postponed following night show amid safety concern record heat recorded brazilian city	Dead Fan
taylor swift debut griefstricken ballad live fan death ta via getty image taylor swift got back business sunday resuming era tour rio de janeiro brazil succession disaster delay friday night swift fan passed away local hospital falling ill nilton santo	Dead Fan
taylor swift get emotional returning stage brazil amid fan death taylor swift returned stage brazil hiatus due sizzling heat seemingly paid tribute fan recently died one show pop superstar put emotional performance sunday estadio nilton santos	Dead Fan
father taylor swift fan died brazil show speaks father ana clara benevides machado taylor swift fan tragically died singer concert brazil speaking yearold young woman died ahead era tour show estadio nilton santos last friday november rio	Dead Fan
taylor swift performs grief ballad bigger whole sky day concert death fan ana clara benevides machado rio de janeiro concert sunday night taylor swift performed deep album cut grief bigger whole sky two day tragic death fan ana clara benevides machado yearold benevides machado died friday falling	Dead Fan
taylor swift postpones brazil era tour following death fan taylor swift began south american leg era tour last weekend argentina next day travis kelce flew see taylor ended rainchecking night show due well rain said twitter love rain show im never	Dead Fan
taylor swift appears honor late fan emotional surprise song choice taylor swift appeared pay tribute late fan ana clara benevides machado emotional song choice night two brazil every show era tour swift performs two surprise song acoustically sunday november swift opted	Dead Fan
taylor swift return stage moving tribute fan died taylor swift shared tearful moment crowd latest concert grammy winner returned stage rio de janeiro nov performed bigger whole sky	Dead Fan
taylor swift give tearful performance tribute deceased fan ana clara benevides swift delivered emotional rendition bigger whole sky taylor swift give tearful performance tribute deceased fan ana clara benevides scoop harrison	Dead Fan
family taylor swift fan died brazil concert call investigation feel loss deeply heart go family friend taylor swift said handwritten statement	Dead Fan
rainsoaked taylor swift performs emotional bigger whole sky honor dead fan last week tough one taylor swift dangerously high temperature brazil thought cause tragic death yearold ana clara benevides machado tended paramedic era tour read	Dead Fan
taylor swift postpones rio concert amid safety concern following fan death taylor swift took social medium saturday evening announce postponing concert amid concern safety	Dead Fan
taylor swift postpones brazil show due heat day fan dy concert taylor swift postponed era tour concert rio de janeiro saturday yearold fan died friday night show according message posted singer instagram	Dead Fan
taylor swift postpones brazil concert fan dy amidst extreme temperature taylor swift announced postponing concert scheduled tonight rio de janeiro fan died attending concert friday night city rio currently experiencing record heat wave generated heat index ie	Dead Fan
taylor swift postpones rio show extreme weather fan death taylor swift postponed concert rio de janeiro brazil yearold fan died friday night show swift era tour	Dead Fan
father taylor swift fan pay tribute daughter died era tour father ana clara benevides machado taylor swift fan died debut era tour concert brazil broken silence death lost daughter happy intelligent girl weiny machado told local newspaper folha de	Dead Fan
taylor swift postpones second night rio hour show following death fan taylor swift saturday postponed second night era tour brazil citing scorching heat stifled south american country past day swift decision announced approximately two hour show w	Dead Fan
taylor swift postpones saturday show rio wake fan death taylor swift postponed saturday night concert rio de janeiro extreme temperature city move come day fan died first era tour show city safety wellbeing fan fellow performer c	Dead Fan
taylor swift postpones nd brazil show amid fan death scorching heat taylor swift postponing second show brazil weekend fan died day prior amid scorching temperature city deems dangerous pop star announced decision saturday long	Dead Fan
swift postpones rio concert devastated fan death taylor swift show rio de janeiro fan fell ill sweltering heat later died pop star said postponed era tour show due extremely high temperature	Dead Fan
see taylor swift debut suburban legend unearth stay beautiful rio show taylor swift dug another pair deep cut rio de janeiro friday singer performed suburban legend stay beautiful	Eras Tour
brasil welcome taylor swift projection christ redeemer rio de janeiro mayor said city would properly honor swift projection compared michael jackson brasil welcome taylor swift projection christ redeemer jo vito	Eras Tour
christ redeemer welcome taylor swift rio philly punt eagleschiefs game taylor swift fan lit brazil christ redeemer statue thursday city brotherly love doesnt share sentiment ahead eagleschiefs game	Eras Tour
taylor swift reacts honored brazil christ redeemer statue credit fan taylor swift reacting warm welcome received brazil week yearold entertainer kicked run show estdio olmpico nilton santos rio de janeiro brazil friday night november thanked fan speci	Eras Tour
taylor swift go brazil swiftie say time people accept mj level famous actually michael jackson level famous yall need finally accept httpstcoftnauglpn thanos thanosnova november taylor swift took era tour brazilthe world famous statue jesus christ christ red	Eras Tour
airline waived flightchange fee thanks taylor swift occasionally airline right thing even mean lose significant money process good news circumstance happened last	Eras Tour
brazil christ redeemer statue welcome taylor swift unique display taylor swift era tour receive special welcome rio de janeiro thursday night projection city iconic christ redeemer	Eras Tour
taylor swift reacts junior jewel tshirt projection onto christ redeemer statue way real video photoshopped songstress say post taylor swift reacts junior jewel tshirt projection onto christ redeemer statue way real video appeared first thewrap	Eras Tour
taylor swift honored brazil projection christ redeemer statue photo grammy winner closing month handful tour date brazil country greeted taylor best way possible	Eras Tour
taylor swift saved public transport fixing airline airline usually stop nothing squeeze every penny book fly one person force hand encourage scrap change fee passenger m taylor alison swiftread	Eras Tour
taylor swift played sang travis kelce buenos aire taylor swift kicked south american leg era tour week first show buenos aire played first night labyrinth live first time thursday friday night show rescheduled sunday	Eras Tour
taylor swift performs slut first time tell fan throw thing onstage eventful trip argentina taylor swift thursday first south american date era tour played first time red taylor version labyrinth midnight live first time friday second buen	Eras Tour
taylor swift reveals fan behavior freak buenos aire concert sunday night taylor swift asked fan stop throwing thing stage saying really freak evermore part era tour set swift paused calmly firmly address crowd present	Eras Tour
taylor swift asks audience hold gift really freak stuff get thrown stage taylor swift like gift stage concert buenos aire argentina swift briefly interrupted show seated piano politely asked fan throw thing stage communication mean gentle	Eras Tour
major airline waived fee taylor swift fan soon taylor swift postponed buenos aire concert south america largest airline offered swifties lifeline	Eras Tour
taylor swift never beating sorcery allegation perfectly timed era tour moment taylor swift proving time time ultimate mastermind pop superstar took twitter share hilarious video era tour stop buenos aire argentina weekend seen singing labyrinth	Eras Tour
taylor swift add two summer london era tour date paramore taylor swift giving uk fan two chance get era tour action singer announced monday nov adding pair gig london stint london wembley arena next summer related taylor swift never	Eras Tour
taylor swift scold concertgoers throwing thing stage buenos aire really freak taylor swift reminding fan throw thing onto stage show least one object made way toward swift buenos aire argentina sunday night nov performing estadio river plate era tour concert	Eras Tour
taylor swift asks fan throw thing stage really freak taylor swift became latest artist request fan dont throw thing stage live show	Eras Tour
taylor swift surprise fan song believed harry style era tour taylor swift era tour surprise song fan thinking harry style saturday night november buenos aire argentina yearold pop titan took stage estadio river plate second performance since resuming tour earlier	Eras Tour
taylor swift wasnt happy postponing era tour stop buenos aire travis kelce reveals travis kelce revealing taylor swift reaction postpone one era tour show buenos aire argentina friday november yearold superstar forced postpone show due weather rescheduled sunda	Eras Tour
taylor swift left argentina quickly still wearing era tour costume taylor swift walked stage final show era tour argentina left country quickly still wearing costume concert new photo emerged showing taylor still midnight outfit boarding	Eras Tour
taylor swift asks fan throw thing stage taylor kindly asking crowd throw thing stage buenosaireststheerastour communication mean gentle healthy boundary really freak stuff get thrown stage	Eras Tour
campaign fundraiser hitting high note taylor swift beyonc concert congressional candidate getting creative fun raise cash taylor version	Eras Tour
watch taylor swift play first night labyrinth live first time buenos aire taylor swift era tour gone worldwide tonight kicked international leg tour buenos aire argentina estadio monumental fan camping since june according pitchfork lucky pop star gave	Eras Tour
taylor swift postpones buenos aire concert truly chaotic weather hit city taylor swift postponed tonight era tour concert buenos aire due called truly chaotic weather description might also apply medium frenzy arrival argentina last night travis kelce kansa city chief tig	Eras Tour
marvel benefit taylor swift era tour boost superteamup taylor swift marvel bring audience together film top weekend box office chart	Eras Tour
amc earnings feature barbie oppenheimer maybe taylor swift beyonc amc entertainment result set released tonight closing bell summer blockbuster movie phenomenon known barbenheimer amc stock far year fell tuesdayamcentertainment barben	Eras Tour
taylor swift beyonce headline list topgrossing summer tour forbes enthusiastic music fan summer filled aliners hitting stage around world pink first woman headline tour wisconsin taylor swift walked runway show throughout united state	Eras Tour
one thing taylor swift isnt talking taylor swift billionaire era tour movie boosted net worth pop star brand benefit downplaying wealth	Eras Tour
get parka ready december canadian swifties havent able focus since taylor swift announced three new concert date step register verified fan presale ticketmaster step look flight vancouverview entire post	Eras Tour
taylor swift add vancouver date era tour vancouver swifties extra something celebrate next holiday season taylor swift added three date city leg era tour new date dec bc place vancouver british columbia gracie ab	Eras Tour
lina khan could learn amazon taylor swift like swift amazon used look answer khan senseless lawsuit found truth	Eras Tour
favorite filmmaker line praise taylor swift sure youve heard taylor swift coming one successful tour time movie theater gangbusters right covered taylor swift got exclusive deal amc many famous filmmaker	Eras Tour
taylor swift illuminati money taylor swift officially billionaire era tour added estimated billion u gross domestic product year	Eras Tour
everything celebrity said taylor swift era tour including olivia rodrigo travis kelce comment celebrity lot say taylor swift era tour since taylor kicked massive tour march arizona biggest star music movie tv even sport enjoyed amazing view vip tent across country	Eras Tour
taylor swift performs safe sound untouchable live first time decade sao paulo taylor swift surprised fan two rarely performed song saturday night concert allianz parque stadium paulo brazil nov tradition started era tour swift said paulo crowd explainin	Eras Tour
taylor swift performs safe sound untouchable live sao paulo song playing tonight never ever played tour swift said acoustic set list allianz parque stadium	Eras Tour
watch taylor swift perform dont talk live first time paulo south american leg era tour taylor swift slowly giving live debut vault track recent release taylor version concert buenos aire pop star performed slut subu	Eras Tour
billy joel dish taylor swift taking daughter era tour billy joel opening experience taylor swift era tour chatting people long island music entertainment hall fame friday november yearold piano man singer shared opinion taylor mass	Eras Tour
tour news taylor swift jerry seinfeld dwarf screaming female roundup recent tour news check tour date category taylor swift taylor swift continues expand era tour added three new vancouver show december tour ever end swifties hope date	Eras Tour
billy joel say scored cool dad point taking daughter taylor swift era tour billy joel earned cool dad point taking daughter see taylor swift concert piano man opened interview people attending pop superstar era tour tampa fla march little pair swift	Eras Tour
taylor swift appears good spirit brazil show one week traumatic death fan pop superstar took stage paulo allianz parque stadium commended fan breaking venue attendance record	Eras Tour
see taylor swift debut dont talk live paulo taylor swift era tour continued friday paulo brazil singer performed pair deep cut surprise song segment	Eras Tour
taylor swift dazzle stage brazil week fan tragic death bejeweled singer put incredible show paulo still mourning death fan rio concert	Eras Tour
rio police investigate taylor swift concert organizer fan death couple protect umbrella high temperature wait taylor swift concert following death fan due heat first day concert rio de janeiro brazil november reuterspilar olivaresf	Eras Tour
taylor swift debut dont talk live sao paulo taylor swift debuted dont talk live first concert paulo brazil friday night nov swift surprised fan city allianz parque stadium taylor version vault track acoustic guitar ive never perfor	Eras Tour
taylor swift hat giveaway leaf lasting impression era tour wrap brazil final note taylor swiftaposs leg era tour wrapping weekend allianz parque stadium sao paulo brazil fan left wanting	Eras Tour
concert chaos taylor swift scream security miranda lambert skewer adele issue warning recent month concert venue witnessed surge dramatic incident fan altercation artist halting performance due security concern renowned figure like taylor swift miranda lambert adele encountered unexpected disruptio	Eras Tour
taylor swift debut dont talk brings back speak fanfavorite sao paulo getty image hadnt played peak selection since video music award	Eras Tour
taylor swift overcomes fan death dazzle sao paulo concert taylor swift returned stage sao paulo brazil week death fan rio de janeiro concert pop superstar dressed glittering silver	Eras Tour
taylor swift paulo concert shatters record largestever crowd hindustan time taylor swift paulo concert shatters record largestever crowdhindustan time taylor swift seems back tragic death fan rio de janeirotmz tragedy hit taylor swift era tour wion eclubwion taylor swift fan given	Eras Tour
taylor swift debut dont talk sao paulo era tour ive never performed one live let see said allianz parque also played innocent live first time	Eras Tour
billy joel got cool dad point taking kid see taylor swift exclusive exclusive conversation people billy joel open wife alexis roderick took two daughter della rose remy anne see meet taylor swift era tour stop tampa florida april	Eras Tour
taylor swift scold security guard miranda lambert skewer fan concert go rail seems lot drama concert lately including performer like taylor swift getting upset security guard shania twain taking tumble	Eras Tour
taylor swift era tour movie leaving theater cinema hitting theater october taylor swift era tour movie performed extremely well domestic worldwide box office soaring past fourth weekend many fan across world wondering era tour leave	Eras Tour
billy joel open taking daughter taylor swift era tour billy joel open taking daughter taylor swift era tourbillboardcom	Eras Tour
fan still waiting ticketet system open month australian leg taylor swift era tour swifties smiling ticketek marketplace working moment ticketek wellestablished australian ticket provider thank ghacks reader	Eras Tour
im swiftie dad traded family summer vacation take kid across country era tour concert worth every penny author regret nixing typical family summer vacation taylor swift concert kevin wintertasgetty image ta right management cork gainesbusiness insider already one taylor swift concert wanted try f	Eras Tour
ticket price see taylor swift brazil dropping ticket already cheaper four day ago	Eras Tour
neuroscience explained taylor swift era tour memorable work right music help make sure important information get remembered	Eras Tour
taylor swift announces era tour show vancouver era tour come bc place december taylor swift announces era tour show vancouver scoop harrison	Eras Tour
five night freddy beat opening weekend ticket sale oppenheimer taylor swift era tour holdover priscilla show initial promise platform debut million freddy easy rider moment gen z	Eras Tour
measure success musician world tour measure success musician world tour many leading music headline past summer touring whether taylor legendary run era tour sheeran monstrous attendance record melbourne crick	Eras Tour
amc entertainment lean concert film era tour success phone ringing hook say ceo theater chain amc make handsome profit distributing taylor swift era tour box office gross passed million globally said ceo adam aron declined give number year end since swift renaissa	Eras Tour
taylor swift era tour concert movie coming streaming soon since theatrical release era tour film busy breaking box office record swifties may able stream concert movie home	Eras Tour
era tour choreographer spill taylor swift favorite routine great guy travis kelce ever wondered taylor swiftaposs favorite dance routine era tour youaposre treat touraposs choreographer mandy moore spilled bea	Eras Tour
taylor swift concert film dominates box office opening weekend hugh mcintyre forbes contributor join forbes newsroom discus taylor swift new concert film taylor swift era tour number one box office opening weekend	Eras Tour
movie back still learning love going theater barbenheimer taylor swift era tour people going cinema postpandemic poststrike hollywood work cut	Eras Tour
taylor swift choreographer spill tea singer fave era tour routine great guy travis kelce really love vigilante st like really love one emmy awardwinning choreographer told page six sexy dance number	Eras Tour
famous couple called quits many dubbed year breakup attribute split powerful feminist message coming barbie era tour read	Eras Tour
irs wont make taxpayer report taylor swift ticket sale online transaction irs postpone enforcement new provision tax code requires online seller report little annual income	Eras Tour
brazilian swiftie went home heel taylor swift bejeweled louboutin boot taylor swift broke heel lover segment era tour show rio de janeiro brazil	Eras Tour
taylor swift shake era tour wardrobe malfunction shoe fit walk til high heel break taylor swift nov stop era tour rio de janeiro performing song lover era	Eras Tour
taylor swift missing chief v eagle game taylor swift rooting football hero afar pop superstar originally planned jet brazil break soldout era tour catch travis kelce kansa city	Eras Tour
taylor swift compared barbie heel mishap brazil show taylor swift reallife barbie doll straight big screen cause mimicked something margot robbie film moment eye heel foot singer performing monday night rio de	Eras Tour
behind extreme heat wave brazil forced taylor swift postpone show thousand taylor swift fan brazil braved extreme heat watch singer perform wildly popular era tour	Eras Tour
taylor swift heel break final rio show barbie comparison made fan taylor swift performed final three era tour concert rio monday night november suffered wardrobe malfunction top show yearold singer performing lover era heel right boot unfortunately	Eras Tour
taylor swift pull barbie move breaking heel third brazil era tour concert video showed singer ripping heel bejeweled christian louboutin boot tossing crowd continuing lover set	Eras Tour
taylor swift support system onstage wardrobe malfunction barbie could never arch	Eras Tour
taylor swift rio tour marred death mugging dangerous heat wave legion taylor swift brazilian fan left angry disappointed threeday rio de janeiro leg pop superstar era tour	Eras Tour
netflix removing title december including taylor swift tour movie love actually netflix released full list movie television show removed streaming service december list includes lot fan favorite title actor like tom cruise leonardo dicaprio fact tom mission	Eras Tour
taylor swift handle wardrobe malfunction like champ continued walk tiptoe quite time mimicking height heel would	Eras Tour
watch taylor swift debut bigger whole sky rio taylor swift live debuted bigger whole sky era tour concert rio de janeiro sunday night	Eras Tour
taylor swift info war weekend taylor swift played longawaited string concert brazil account disaster	Eras Tour
live nationticketmaster subpoenaed senate subcommittee investigating hefty price taylor swift concert senate subcommittee subpoenaed live nationticketmaster demanding document part investigation exorbitant ticket price taylor swift bruce springsteen concert sen richard blumenthal dct chair permanent subco	Eras Tour
taylor swift appears hard time breathing brazil show new tiktok video swifties concerned taylor swift video friday november era tour concert rio de janeiro brazil look like yearold singer hard time breathing antihero singer performed extreme heat keep	Eras Tour
taylor swift seemingly struggle breathe brazil concert taylor swift seemingly gasping air sweltering hot concert brazil freaking fan pop superstar performed hour nearly degree heat friday night estadio nilton santos stadium rio de janeiro	Eras Tour
aew tony khan take credit taylor swift era tour london show comrade connoisseur squared circle catchy pop hook alike gather round el presidente coming live lavish banquet inside gilded hall secret volcanic lair today toast strategic alliance ser	Eras Tour
taylor swift postpones saturday night era tour show rio due extreme temperature sad news swifties saturday afternoon november taylor swift announced postponing era tour show scheduled later night rio de janeiro brazil due extreme temperature keep reading find im writing	Eras Tour
rachel zegler recall food poisoning mental breakdown taylor swift era tour rachel zegler opening love taylor swift emotional night era tour show new jersey thursday november hunger game star appeared tonight show revealed food poisoning taylor first e	Eras Tour
heather morris dish podcast bystander relationship glee costars era tour v renaissance tour exclusive heather morris opening murder mystery podcast former glee costars beyonc taylor swift yearold multihyphenate creative best known playing glee character brittany pierce call goat ment	Eras Tour
taylor swift postpones show brazil due extreme heat tonight era tour show postponed due extreme heat safety wellbeing fan fellow performer crew always come first taylor riotstheerastour tstheerastour pictwittercomqhuwtvf taylor swift	Eras Tour
christ redeemer taylor version throughout taylor swift era tour city bent backward welcome town latest gesture rio de janeiro surpasses rest thursday swift arriving town run show estadio nilton santos swiftthe	Eras Tour
dont expect taylor swift concert film hit streamer year taylor swift blockbuster taylor swift era tour still performing well box office wont available stream least january	Eras Tour
brazilian fan want make jesus swiftie group swifties praying honor taylor swift projection onto rio de janeiro christ redeemer statue ahead erastour show	Eras Tour
taylor swift secret song left era tour every song hasnt performed yet taylor swift performs two surprise song acoustic set every show era tour already performed ton incredible track first u leg yearold singer getting ready continue south american leg	Eras Tour
devotion drive demand taking page era tour driven insatiable fan devotion era tour juggernaut blown value line water	Eras Tour
taylor swift era tour movie shown monday tuesday wednesday taylor swift era tour movie surprisingly screened thursday friday saturday sunday fan want know showing monday tuesday wednesday need know taylor swift era tour movie	Eras Tour
strike damage theater begun taylor swift barbie oppenheimer sound freedom saved next year need surprise blockbuster paper gap	Eras Tour
swifties think taylor swift made big revelation travis kelce onstage era tour taylor swift returned era tour thursday night november swifties convinced used opportunity make big revelation travis kelce yearold pop titan took stage estadio river plate buenos aire	Eras Tour
taylor swift go barbiecore pink versace lover outfit era tour buenos aire hiatus swift resumed era tour versace	Eras Tour
taylor swift didnt attend beyonce movie premiere bey surprise era tour premiere appearance taylor swift missing premiere beyonces new movie renaissance film beyonce saturday night november good reason forgot break soul superstar surprise celebrity guest red carpet tayl	Eras Tour
dolly parton taylor swift celebrity specie named scientist love naming new specie celebrity david bowie spider dolly parton lichen famously named specie	Global influence
taylor swift teach u leadership taylor swift isnt incredibly savvy entrepreneur consistently demonstrates sophisticated leadership quality applied workplace	Global influence
idfa orwa nyrabia criticizes documentary distributor populist mentality playing safe live taylor swift documentary gatekeeper playing awfully safe lately estimation orwa nyrabia artistic director international documentary festival amsterdam world largest documentary film festival conversation deadline st	Global influence
market theme discus around thanksgiving table plenty market talk passing potato thanksgiving inflation work artificial intelligence labor strike even taylor swift may fodder turkey day table talk help guide discussion top executi	Global influence
famous song singer clearly lying u see taylor swift clue	Global influence
anyone else finding simu liu music career perhaps inspired drake surprise album release today even megastars like beyonc taylor swift whove seen huge return similar strategy past marvel actor oneofthekens simu liu banking nothing power stard	Global influence
bts taylor swift influence pop music fan swifties like proven exert influence political social change	Global influence
could taylor swift trigger next american baby boom blog post published early october predicted taylor swift create next baby boom	Global influence
refreshing wall street analyst show theyre taylor swift superfans riffing song usually wonky research note analyst giving nod swift reign pinnacle pop culture referencing lyric financial research	Global influence
brazilian swifties want literally make taylor swift big jesus taylor swift exactly big jesusor least brazilian swifties way course era tour weve following way tour stop scrambled express deference devotion conquering pop star	Global influence
taylor swift money jar go viral husband make wife pay taylor talk husband going viral putting taylor swift tip jar house making wife pay every mention pop star boyfriend travis kelce maryland resident dana rice shared clip hubby new invention	Global influence
swifties think taylor swift wrote argylle novel week ago new trailer caught eye spy comedy thriller called argylle looked like ton fun apparently movie based book title set released january adaptatio	Global influence
nfl midseason report reveals jump overall betting taylor swift effect full force betmgm released midseason nfl betting report chief eagle popular super bowl favorite betting data information bet	Global influence
taylor swift popular pop star currently listenedto artist planet thanks legion devoted superfans behind mass appeal	Global influence
gen z financial icon revealed taylor swift beat warren buffett bill gate top list bill gate beyonc oprah winfrey made list people embody financial success gen z according new survey college student	Global influence
gannett hired taylor swift writer admit first quote saw new taylor swift beat writer gannett made roll eye shake head bryan west post gannett hired taylor swift writer appeared first poynter	Global influence
merry swiftmas amy scott creates viral naperville taylor swift house atlas lane inspired era tour movie merry swiftmas amy scott creates viral naperville taylor swift house atlas lane inspired era tour movieabcchicagocom	Global influence
im swiftie dad traded family summer vacation take kid across country era tour concert worth every penny instead disney world beach took girl see favorite artist second time	Global influence
taylor swift ticket paris trip dining consumer splurge even saving fall yolo consumer splurging entertainment travel dining boosting economy saving taking hit	Global influence
taylor swiftapproved black friday deal red lipstick reformation dress black friday sadly isnt delivering deal era tour ticket swifties save big superstar fashion beauty favorite	Global influence
hottest baby name trend taylor swift wednesday barbie inspiring parentstobe baby name expert sharing hottest trend past year inspired expectant parent taylor swift album film athlete highlight	Global influence
la vega readying lavender haze raider play chief swifties known taylor swift fandom course often known wild football	Global influence
erin andrew goto karaoke song classic taylor swift hit erin andrew swiftie surprise chooses turn karaoke bar goto karaoke song anything taylor swift taylor version especially style blank space andrew exclusively tell u week	Global influence
meet typical swiftie white suburban millennial woman may spent go era tour taylor swift fernando leontasgetty image ta right management secret taylor swift helped prop u economy last year typical swiftie spending go era tour might make swifties sk	Global influence
swifties threaten boycott netflix taylor swift reputation stadium tour removed next month netflix realize many people going cancel subscription five year taylor swift reputation stadium tour reportedly leaving netflix	Global influence
taylor swift effect activated community huge impact sale business	Global influence
taylor swiftthemed cruise set sail swifties couldnt attend era tour could trade friendship bracelet sea instead learn taylor swiftthemed cruise setting sail	Global influence
everything need know taylor swift themed cruise taylor swift themed cruise setting sail next year giving swifties chance experience wildest dream	Global influence
dancing star taylor swift night harry jowsey rylee arnold take page six inside rehearsal hot handle star pro partner exclusively took page six behindthescenes rehearsal upcoming swiftthemed episode watch sneak peek routine	Global influence
yes royal caribbean cruise taylor swift fan taylor swift already major presence royal caribbean cruise ship popular part playlist various dj board live artist pub schooner bar often cover song one pub guitarist ellie finnerty earli	Global influence
choreographer mandy moore judging dwts taylor swift night choreographer mandy moore ready watch remaining dancing star contestant shake competition show announced nov episode celebration taylor	Global influence
live kelly mark treated largest audience year taylor swiftinspired halloween episode exclusive trick treat year halloween episode live kelly mark live halloween era show scored viewer october making mostwatched halloween episode four year according nielsen data	Global influence
aboard taylor swift cruise era tour coming high sea sort taylor swift fan setting sail taylorthemed royal caribbean cruise next year	Global influence
taylor swift surprise dwts cast sends message support musicthemed episode taylor swift made surprise appearance dancing star tuesday night november via prerecorded video message yearold entertainer appeared screen ballroom surprising dancer viewer ahead upcoming c	Global influence
dancing star announces first taylor swift night abc finally confirmed taylor swiftthemed night dancing star season tune celebration taylor swift	Global influence
taylor swift airbnb bachelorette dream home megafans bask era night rent taylor swift airbnb scottsdale arizona room devoted different era reputation lover folklore	Global influence
world first taylor swift trivia escape room coming toronto taylor swiftthemed escape room coming toronto tailormade swifties city courtesy trivia escape room dupont st room available advanced booking officially open dec taylor birthday w	Global influence
lyft unveiled new extra comfort option better car driver option frozen land come disneyland hong kong taylor swift fan getting cruise	Global influence
jason mraz reflects working generous taylor swift performing song dancing star exclusive new interview page six singer recalled like performing im pop star speak tour stop los angeles	Global influence
taylor swift surprise dancing star fan special message taylor swift grooved way onto dancing star stage surprising contestant audience special video message night theme celebration taylor swift hey guy taylor want say	Global influence
taylor swift night dancing star jason mraz got perfect score taylor swift currently song america feel like small potato point swift basically bigger popular music day everything cultural event taylor swift show brazil	Global influence
dancing star score revealed contestant taylor swift night week eight dancing star come close score revealed episode nine abc dancing competition series aired tuesday night november couple took ballroom taylor swift night guest judge	Global influence
abc exec reacts report swifties got harry jowsey eliminated dancing star abc executive speaking harry jowseys elimination dancing star network exec reacted theory online taylor swift fan swifties hand eliminating yearold reality tv star competition	Global influence
taylor swift brings good luck dwts harry jowsey sent packing eric mccandlessdisney first taylor swift came harry style singer eliminated harry jowsey dancing star people named harry ought watch back nextprince harrytuesday night highly anticipated taylor	Global influence
dwts tribute taylor swift deserves mirrorball trophy dancing star entered taylor swift era nov abc dance competition celebrated superstar singer night dedicated greatest hit course	Global influence
dancing star week record number voter send someone home taylor swift night admit started episode knowing going go home right true student dancing star able predict order celebs given boot sure occasional misstep many	Global influence
dancing star spoiler went home night nine see spoiler alert continue reading dont want know happened dancing star latest episode episode nine dancing star aired abc tuesday november contestant competed show week eight	Global influence
dancing star x x celebration taylor swiftthe six remaining couple dance music taylor swift guest judge mandy moorepartner dance alyson sasha cha cha ariana pasha rumba jason daniella argentine tango	Global influence
harry jowsey kiss rylee arnold dwts rumba say harry jowsey clearing air speculated kiss rylee arnold dancing star taylor swift night oh didnt kiss dance jowsey said entertainment weekly wednesday november interview reality	Global influence
dancing star semifinalist revealed taylor swift night feel like perfect night send another couple home tuesday night dancing star pair took taylor swift song mandy moore lead choreographer era tour joined ballroom guest judge impres	Global influence
dancing star week jason mraz retake lead taylor swift night article contains spoiler nov episode dancing star remaining six couple danced song taylor swift tuesday night dancing star era tour choreographer mandy moore sat guest judge swift	Global influence
swifties apparently mobilized vote harry jowsey dancing star taylor swift night dont doubt swifties	Global influence
cofounder taking part woman health revolution future woman health taylor swiftthemed cruise plus forbes community	Global influence
instead taylor swift beat reporter need nextdoor beat reporter time local news version muchcited willie sutton quote robs bank addition creating news website trying lure people post instead taylor swift beat reporter need nextdoor beat reporter appeare	Miscellaneous Facts
instead taylor swift beat reporter need nextdoor beat reporter time local news version muchcited willie sutton quote robs bank addition creating news website trying lure people visit place reporter reader already nextdoo	Miscellaneous Facts
fact check taylor swift photographed eating ice cream child cry image shared november authentically showed taylor swift holding ice cream cone child cry beside	Miscellaneous Facts
marvel president address harry style return franchise taylor swift deadpool rumor chance harry style returning marvel cinematic universe taylor swift joining marvel president kevin feige addressed rumor forgot yearold watermelon sugar superstar made introduction mcu	Miscellaneous Facts
john mayer famous ex include taylor swift jennifer aniston full dating history revealed taking look back john mayer love life back november yearold free fallin singer sparked romance rumor yearold actress reportedly spent four hour together hanging restaurant photo c	Miscellaneous Facts
brittany mahomes share look girl night taylor swift squad already big reputation theyre continuing prove fabulous brittany mahomes recently gave inside look recent night new	Miscellaneous Facts
taylor swift accused witchcraft maga pastor hank kunneman hank kunneman employed maga pastor bad work stomach spouting uncreative discredited conspiracy theory dimwitted credulous perpetually enraged trump worshipper know kunneman probably remember	Miscellaneous Facts
taylor swift debut brittany mahomes instagram w boozy photo taylor swift brittany mahomes friendship instagram official cause wife chief superstar qb finally shared personal pic weekend nyc singer spent quality time fellow kc wag	Miscellaneous Facts
taylor swift magic johnson financial playbook compounding wealth like billionaire taylor swift magic johnson newlyminted billionaire talent simple investment strategy could offer anyone path wealth	Miscellaneous Facts
taylor swift enjoying new york city lady post taylor swift enjoying new york city lady first appeared go fug	Miscellaneous Facts
beatles dethrone taylor swift spotify beatles back first new single decade fan showing support tune	Miscellaneous Facts
elon musk appears given trying camouflage privatejet travel faa program used jeff bezos taylor swift elon musk signed faa pia program allows private jet owner fly incognito appears stopped using	Miscellaneous Facts
taylor swift earnings visualized bracelet bead bloomberg estimate taylor swift reached billionaire status recent touring music release swift achieved milestone mostly music bloomberg provides visual split wit	Miscellaneous Facts
spotify hack transformed music thanks taylor swift world music streaming every note nuance count thanks taylor swift indirectly ive found hidden setting need turn best experience music spotify	Miscellaneous Facts
taylor swift brent faiyaz silvana estrada week pitchfork selects playlist weekly playlist highlight song writer editor contributor listening repeat	Miscellaneous Facts
celebrity attend renaissance film beyonc red carpet premiere michelle williams pose photo premiere beyonc renaissance concert film pictwittercomvncbvpyxk variety variety november celebrity tonight attending red chrome carpet premiere renaissance film b	Miscellaneous Facts
select taylor swift vinyl select kodak film camera select preloved zimmermann ebay part ebay black friday test knowledge taylor swift vinyl txn pp max disc select item code available tc apply q name taylor swift second album fearless kodak film camera txn pp max disc	Miscellaneous Facts
deadpool ryan reynolds love taylor swift mcu rumor receiving prestigious order british columbia deadpool star ryan reynolds addressed recent taylor swift mcu rumor highlyanticipated third installment speaking vancouver sun reynolds didnt confirm deny swift involvement	Miscellaneous Facts
deadpool officially resume shooting ryan reynolds chime recent taylor swift rumor one deadpool executive producer confirmed marvel studio threequel resumed shooting uk ryan reynolds broken silence rumour taylor swift cameo	Miscellaneous Facts
taylor swift deadpool ryan reynolds say deadpool star ryan reynolds share cryptic reaction taylor swift cameo rumor	Miscellaneous Facts
beyonc drop surprise second trailer renaissance tour film beyonc fan already friday december marked calendar day polymath concert documentary renaissance film beyonc set hit theatersand day concert film box office record set taylor swift era	Miscellaneous Facts
ryan reynolds break silence deadpool cameo love taylor swift rumor infamous merc mouth gearing longawaited return sony picture marvel studio deadpool subject bit reshuffling official release date ryan reynolds titular antihero aside diff	Miscellaneous Facts
beyonc hype renaissance tour film new trailer macy thanksgiving day parade season upon u mean concert tour movie season unlikely shell able top surprise success taylor swift era tour film beyonc getting hype dropping brand new trailer	Miscellaneous Facts
record store day black friday wanted olivia rodrigo musthave ep plus vinyl exclusive noah kahan na joni mitchell brutal may good description record store day black friday feel customer appetite set limitededition piece olivia rodrigo coming occasion rodrigo essentially playing	Miscellaneous Facts
fan mock tony romo reaction dolly parton performance dolly hotter taylor swift tony romo part cbs team covering dallas cowboysapos thanksgiving game witnessed dolly partonaposs captivating halftime show wore bedazzled cowboy che	Miscellaneous Facts
ryan reynolds break silence taylor swift deadpool role revealed expansive marvel cinematic universe buzz surround rumor taylor swift possibly portraying dazzler deadpool ryan reynolds deadpool lead addressed speculation	Miscellaneous Facts
banker turn sneaker chance golden goose ipo banker vying role golden goose initial public offering least bank wearing golden goose sneaker pitch meeting luxury italian shoemaker sneaker worn celebrity like selena gomez taylor swift	Miscellaneous Facts
joe biden mistake britney spear taylor swift prethanksgiving speech joe biden got little mixed prethanksgiving speech annual turkey pardoning monday november also happened st birthday president talked difficult journey turkey went traveling	Miscellaneous Facts
biden turn pardon turkey confuses taylor swift britney spear big bird man im impressed biden said ceremony confused britney spear taylor swift	Miscellaneous Facts
biden confuses taylor swift britney spear awkward turkey pardon moment leah millisreuters lighthearted prethanksgiving ceremony joe biden granted pardon turkey liberty bell white house monday president gasp appeared confuse taylor swift britney spear reference	Miscellaneous Facts
biden confuses taylor swift britney spear joking age st birthday biden quipped turning white house annual thanksgiving turkey pardon monday	Miscellaneous Facts
biden struggle incomprehensible joke taylor swift britney spear brazil turkey pardoning president joe biden struggled incomprehensible joke taylor swift concert rio de janeiro turkey pardoning ceremony white house monday woman died due heat swift performance friday night bi	Miscellaneous Facts
joe biden say britney spear touring brazil joe biden mistake taylor swift britney spear turkey pardoning speechthis harder getting ticket renaissance tour britney tourit kind warm brazil right pictwittercomvoifwhqlg pop crave popcrave novem	Miscellaneous Facts
dont hold anything back meet old gay tiktok influential pensioner written description quite capture joyinducing positivity online video bopping along taylor swift slinky striped swimwear countless dance trend tiktok challenge completed various seductive state undress twirling wh	Miscellaneous Facts
hollywood biggest celebs fly high private jet way fly hollywood biggest star flying high day eschewing commercial air travel luxurious lavish experience private aircraft bigtime celebs like kim kardashian taylor swift beyonc joh	Miscellaneous Facts
renaissance film beyonce hope pull single lady opening exclusive amc second concert movie renaissance film beyonce hit tracking recently opening projection youll remember circuit world distributing movie exhibitor variance tap	Miscellaneous Facts
drake shout taylor swift surprise release well look like drake tummy isnt hurting much anymore week announcing hed taking extended break music deal health complicationsspecifically fact hed craziest problem year	Music Releases
drake honor taylor swift new song red button drake rap taylor swift new song red button featured part justreleased scry hour collection	Music Releases
taylor swift reputation taylor version release date november fan hyped taylor swift reputation taylor version release date many believing coming november latest information potential launch date new tv album reputation taylor	Music Releases
drake praise taylor swift one could make drop album little later rapper shout fellow pop star new scary hour cut red button drake praise taylor swift one could make drop album little later eddie fu	Music Releases
drake red button lyric mention taylor swift pushing back album drake dropped new album scary hour feature song red button mention taylor swift throwing shade success taylor album midnight last year drake admitting person get hi	Music Releases
easter egg hint taylor swift dropping reputation next time swifties guessing musical sensation going announce rereleasing reputation album next	Music Releases
drake shout taylor swift new song scary hour album listen rapper made sure praise antihero songstress revealed postponed album new record released november	Music Releases
taylor swift song best investment advice goldman sachs say isnt first time taylor swift occupied head space wall street forecaster economist year	Music Releases
diane warren tout cool brady cast singer taylor swift sound screen film diane warren lined allstar girl group including debbie harry dolly parton belinda carlisle cyndi lauper gloria estefan sing gon na film brady love great artist warren said thursday deadline sound scree	Music Releases
buccaneer director susanna white talk bridgerton comparison taylor swift reveals feature developed bfi teen year exclusive veteran british director susanna white revealed working debut feature film based teenage life fashion world gear today launch apple tv period drama buccaneer white developing untitled scri	Music Releases
kelly clarkson say taylor swift sends flower every rerecording release kelly clarkson know well sweet taylor swift superstar revealed e news antihero superstar sends gift album release know funny sent flower kelly clarkson show host shared	Music Releases
taylor swift sends kelly clarkson flower every rerecording gesture gorgeous kelly clarkson recently revealed sweet gift received taylor swift fan wont able shake know funny sent	Music Releases
taylor swift swerve expectation new track slut prologue taylor version explains exactly kind scrutiny original album made become target slut shamingthe intensity relentlessness would criticized called happened tod	Music Releases
new album listen taylor swift sofia kourtesis stream new release taylor swift sofia kourtesis mountain goat ragana shabazz palace murda beatz shordie shordie ryan davis roadhouse band mara jos llergo new age doom tuvaband	Music Releases
kendrick lamar taylor swift rerecord bad blood taylor version listen watching kendrick lamar create record verse bad blood remix one inspiring experience life swift gushed	Music Releases
taylor swift announce reputation taylor version taylor swift seemingly dropped hint plan announce reputation taylor version one brazil era tour concert	Music Releases
lana del rey explains happened first version taylor swift collab beach lana del rey dishing really went first version taylor swift collaboration snow beach midnight album yearold songstress featured track initially came fan noticed th	Music Releases
drake competing taylor swift leveraging name another hit drake namedropped taylor swift new song red button featured scary hour edition album dog smart move part	Music Releases
taylor swift block beatles hitting beatles two album looking hit uk neither could compete taylor swift taylor version	Musical Accomplishments
jung kook blocked making billboard history taylor swift jung kook debut album golden made strong entry billboard chart couldnt compete taylor swift taylor version	Musical Accomplishments
taylor swift match one bts impressive chart feat taylor swift bts musical act hit hot replace another singlethen see first win return summit	Musical Accomplishments
britney spear remembers meeting taylor swift first time call iconic pop woman generation britney spear known princess pop giving taylor swift flower calling iconic pop woman generation spear took social medium share throwback year ago posing photo swift bad bl	Musical Accomplishments
taylor swift ensures men chart top hit week single male artist found inside top hot week taylor swift doja cat sza dominate highest reach chart	Musical Accomplishments
taylor swift replaces hot taylor swift single cruel summer rebound hot taking debuted atop tally last week	Musical Accomplishments
taylor swift inching closer billboard chart record one want taylor swift seen nine different song stop hot one rung shy becoming charttoppers	Musical Accomplishments
taylor swift smash record timebut cant quite catch adele taylor swift new album taylor version scored secondlargest debut billboard history among womencoming behind adele	Musical Accomplishments
taylor swift phenomenon yearold pop star build recordshattering global music empire	Musical Accomplishments
gracie abrams reveals taylor swift creamed text grammy nomination gracie abrams opening taylor swift reacted grammy nomination friday november yearold singersongwriter nominated best new artist yearold grammys veteran received six nomination major	Musical Accomplishments
taylor swift get dinner gracie abrams hour arriving back nyc argentina photo taylor swift gracie abrams grabbed dinner together definitely something celebrate grammy nomination yearold cruel summer singer yearold know wont work singer seen leaving meal freeman	Musical Accomplishments
taylor swift named apple music artist year apple today announced taylor swift named apple music artist year reaching new realm superstardom year swift released new album last month called taylor version tour	Musical Accomplishments
taylor swift set grammy award record antihero nomination midnight singer received six nomination	Musical Accomplishments
taylor swift named apple music artist year taylor version apple named taylor swift apple music artist year across chart stream concert stadium filled screaming braceletwearing super fan swift undeniably reached new realm superstardom year apple explains	Musical Accomplishments
apple music celebrates taylor swift artist year taylor swift named apple music artist year setting recordbreaking milestone receiving prestigious apple music awardthroughout year swift achieved remarkable feat charttopping song massive streaming number	Musical Accomplishments
grammy nomination taylor swift sza phoebe bridgers victoria mont lead nominee billie eilish olivia rodrigo miley cyrus also netted multiple nomination year	Musical Accomplishments
taylor swift sza lana del rey nominated album year grammys also running olivia rodrigo boygenius janelle monae miley cyrus jon batiste	Musical Accomplishments
album year grammy nominee include boygenius lana del rey olivia rodrigo taylor swift year grammy nomination coming morning know compete year biggest prize eight album nominated album year category critical commercial heavyweight	Musical Accomplishments
taylor swift match one michael jackson impressive billboard chart record taylor swift collect third hot manages odd rare chart feat	Musical Accomplishments
taylor swift break record song year grammy nomination antihero give taylor swift seventh song year grammy nomination break tie paul mccartney lionel richie ever	Musical Accomplishments
taylor swift tie record album year grammy noms among woman taylor swift collect sixth album year grammy nomination tying barbra streisand nod among woman ever	Musical Accomplishments
taylor swift break hot tie bts ariana grande taylor swift new single start time hot giving singer sixth debut atop competitive billboard chart	Musical Accomplishments
taylor swift sza jon batiste album year grammy nominee arent many shock album year category year grammys name like taylor swift sza olivia rodrigo leading charge	Musical Accomplishments
grammy prediction taylor swift sza barbie album year taylor swift win album year grammy recordsetting fourth time certainly seems like lock nomination	Musical Accomplishments
taylor swift tie bad bunny claim song world taylor swift biggest song world week doesnt mark first time hit billboard global	Musical Accomplishments
jung kook beat taylor swift next week billboard chart taylor swift taylor version guaranteed hold second week prediction jung kook golden growing	Musical Accomplishments
taylor swift apple music artist year apple music crowned taylor swift artist year testament unwavering popularity sheer volume streaming success recordsetting song apple music global daily top within ten month swift r	Musical Accomplishments
taylor swift tie record album year grammy noms among woman taylor swift latest fulllength album original material midnight contender album year grammy come surprise absolutely one set named likely nominee moment dropped perhaps even ear	Musical Accomplishments
taylor swift take large bite named apple music artist year taylor swift named apple music artist year solidifying status global music phenomenon throughout year swift achieved unprecedented success song dominating apple music global daily top first month	Musical Accomplishments
taylor swift sza jon batiste album year grammy nominee make release album year completely interpretation grammy voter made difficult predict past year trophy gone surprising title artist recently arent	Musical Accomplishments
taylor swift defeat taylor swift also everybody else sale taylor version taylor swift officially beaten pretty much person planet giving real fight pop music dominance moment per deadline reporting first serious sale number swift latest release taylor	Musical Accomplishments
taylor swift land biggest sale week career taylor version album debut billboard best album done sale subce adele	Musical Accomplishments
taylor swift top canceled mtv ema award taylor swift nicki minaj jung kook maneskin win big canceled mtv ema award see full winner list	Musical Accomplishments
taylor swift take top hot swift hold chart following release taylor version dethroning cruel summer number one	Musical Accomplishments
mtv emas winner taylor swift jung kook teatime everybody agreesthat taylor swift top winner mtv emas originally scheduled nov ceremony paris ultimately canceled network still marked	Musical Accomplishments
taylor swift prof sell album like musician history taylor swift seen six different album move least one million copy single weekthe among act new set taylor version latest	Musical Accomplishments
taylor swift claim three bestselling album america taylor swift claim top three bestselling album u led taylor version followed midnight speak taylor version	Musical Accomplishments
taylor swift tie whitney houston latest single taylor swift new single yet mark eleventh song hit hot fourth among solo female artist	Musical Accomplishments
taylor swift claim half top song america week taylor swift chart top hit hot week invades ranking song new album taylor version	Musical Accomplishments
taylor swift score biggest debut year taylor version taylor swift back billboard taylor version rerecorded take pop blockbuster debut first place ranking topconsumed album u largest starting sum significan	Musical Accomplishments
taylor swift may replace atop hot next week taylor swift may replace hot net week swapping current ruler cruel summer	Musical Accomplishments
taylor swift break record largest vinyl sale week ever taylor version taylor swift taylor version sold least copy vinyl alone le week new record america	Musical Accomplishments
taylor swift break tie justin bieber cruel summer gain taylor swift single cruel summer becomes moststreamed song america first time week helping make history	Musical Accomplishments
taylor swift person year best thing happening america taylor swift named quotperson yearquot wall street journal columnist peggy noonan oped headlined quotwe give thanks taylor swiftqu	Musical Accomplishments
every song went artist like miley cyrus taylor swift drake defined pop music year reigning atop hot chart multiple week	Musical Accomplishments
official uk top single chart tracklist jack harlow lovin new entry dua lipa houdini new entry ca raye dblock europe prada tate mcrae greedy noah kahan stick season beatles taylor swift taylor version	Musical Accomplishments
taylor swift extends australian chart streak taylor version taylor swift make full month australia taylor version via universal longest reigning four rerecorded album swift latest hit lp hold stray kid rockstar inguniversal unchanged ho	Musical Accomplishments
taylor swift reign full month australia taylor version taylor swift one globally renowned american musician topped chart australia latest album taylor version number one position country whole month per report rerecorded album r	Musical Accomplishments
aria chart taylor swift jack harlow extend reign homegrown rapper chillinit bag highest score week mixtape dna	Musical Accomplishments
give thanks taylor swift right time magazine would choosing person year designation ive followed childhood choice tend vary sound interesting also almost always know theyll choose enjoy finding im right h	Musical Accomplishments
taylor swift tie adele continues rule hot taylor swift rule hot fifth consecutive week cruel summer dominates adele spent number week	Musical Accomplishments
billboard music award complete winner list taylor swift morgan wallen take top trophy karol g peso pluma zach bryan fuerza regida also triumph big night taylor swift morgan wallen billboard music award took trophy swift category like top artist top female artist top hot songwriter top country female artist top selling song fo	Musical Accomplishments
way taylor swift made history billboard music award taylor swift tied billboard music award win history drake artist came top several category ceremony	Musical Accomplishments
billboard music award complete winner list trophy go billboard music award took place nov night big winner morgan wallen received accolade win taylor swift followed	Musical Accomplishments
taylor swift reacts prize haul billboard music award unreal taylor swift took home win billboard music award sunday feel like luckiest person world corner told fan	Musical Accomplishments
biggest snub surprise grammy nomination sza taylor swift victoria mont phoebe bridgers among nominated artist grammy award	Musical Accomplishments
boygenius olivia rodrigo miley cyrus nominated record year grammys sza taylor swift billie eilish victoria mont jon batiste also award	Musical Accomplishments
billie eilish dua lipa sza nominated song year grammys taylor swift olivia rodrigo lana del rey jon batiste miley cyrus round nominee year	Musical Accomplishments
biggest snub surprise grammy nomination love lana del rey le drake country music saw nomination major artist like taylor swift billie eilish sza coming recording academy still managed keep u toe number shocking decision artist pleasantly surprised see get nod	Musical Accomplishments
hunger game ballad songbird snake spotify key partner country music infused prequel exclusive music continually facet lionsgate billion hunger game franchise going back ditty taylor swift coldplay lorde today theatrical release lionsgate hunger game ballad songbird snake	Miscellaneous Facts
affordable jewelry brand taylor swift keep wearing travis kelce black friday sale sale today	Travis Kelce
bleacher hey joe taylor swift ex joe alwyn getty image taylor swift joe alwyn former relationship feel old travis kelce recently resurfaced tweet	Travis Kelce
philadelphia radio station wont play taylor swift song ahead eagle v chief pop superstar taylor swift native pennsylvania grew philadelphia eagle fan allegiance kansa city chief star tight end travis	Travis Kelce
people obsessed taylor swift travis kelce rolling stone staff theory rolling stone staffer offer theory everyone obsessed taylor swift travis kelce relationship	Travis Kelce
taylor swift music punted philly radio station eagleschiefs game listener philadelphia q wont hearing taylor swift music weekend popular radio station say city football team need distraction prior game kansa city chief swift beau travis kelce monday night	Travis Kelce
taylor swift bring parent chief v eagle game time parent watch boy football team taylor swift bring mom andrea swift dad scott swift watch kansa city chief face	Travis Kelce
jake state farm say taylor swift belongs travis kelce jake state farm taylor swift travis kelce love story straight wildest dream sweetest thing ever insurance company spokesmodel kevin mile told e	Travis Kelce
everything know taylor swift travis kelce comprehensive guide detail taylor swift travis kelce relationship era tour chief game	Travis Kelce
kelce becomes top trending dog name amid nfler romance taylor swift whether name silly serious pet parent influenced name remind favorite thing trending pop culture moment	Travis Kelce
travis kelce give taylor swift sweet shoutout podcast travis kelce giving taylor swift special shoutout friday november episode new height podcast yearold kansa city chief tight end brother jason kelce showed artwork received fan one cartoon draw	Travis Kelce
taylor swift travis kelce plotting parent mashup ahead thanksgiving taylor swift travis kelce courtship continues theyve rubbing elbow parent one group taylor swift travis kelce plotting parent mashup ahead thanksgiving originally published hollywood gossi	Travis Kelce
joy behar hurl mean insult travis kelce view chat taylor swift love view host viciously dragged chief tight end relationship pop star	Travis Kelce
need stop regarding taylor swift travis kelce romance something remarkable look look thing watched footage taylor swift running towards travis kelce hugging bazillion time person alive internet connection even person doesnt internet conn	Travis Kelce
taylor swift trying attend travis kelce monday game important reason taylor playing show brazil sunday night really important	Travis Kelce
chief chris jones seemingly confirms taylor swift eagle game david eulittgetty image amy sussmangetty image kansa city chief player chris jones appears insider knowledge whether taylor swift planning attend travis kelce monday night football matchup philadelphia eagle jones	Travis Kelce
travis kelce shout out taylor swift putting map travis kelce appreciative girlfriend taylor swift making household name friday november bonus episode new height podcast travis brother jason kelce showed artwork received fan cartoon	Travis Kelce
travis kelce jersey dating taylor swift heat demand home away chief gear fanatic travis kelce jersey shipped old new kansa city chief fan taylor swift fan	Travis Kelce
derek jeter speaks travis kelcetaylor swift romance travis kelce taylor swift romance almost certainly biggest sportsentertainment romance history term medium attention former yankee legendary shortstop derek jeter secret highprofile relationship weighed	Travis Kelce
chipotle travis kelce taylor swift joke go viral people teased kansa city chief tight end commitment misspelling old post made x	Travis Kelce
taylor swift exiled philadelphia radio station kelce brother eagle v chief game weekend really important show support bird q nugget say post taylor swift exiled philadelphia radio station kelce brother eagle v chief game appeared first thewrap	Travis Kelce
hilariously wholesome travis kelce tweet life taylor swift post hilariously wholesome travis kelce tweet life taylor swift appeared first pleated jean	Travis Kelce
travis kelce give taylor swift shoutout ahead era tour concert brazil kansa city chief tight end addressed running joke swift put map friday episode new height podcast	Travis Kelce
golden tate angered brian kelly hitting taylor swift practice notre dame golden tate little extra spring step taylor swift selena gomez town notre dame former biletnikoff awardwinning wide receiver remembers like yesterday shot shot international superstar practic	Travis Kelce
skip bayless hope wrong fake taylor swift skip bayless explained isnt buying travis kelce taylor swift whirlwind romance	Travis Kelce
travis kelce old tweet reposted taylor swift fan ahead eagle v chief taylor swift fan passionate unique bunch swifties digging old tweet travis kelce swift current beau point many	Travis Kelce
gigi hadid declares stance taylor swift travis kelce romance gigi hadid setting record straight stand best friend taylor swift romance chief tight end travis kelce	Travis Kelce
taylor swift fan spot another secret message sent travis kelce argentina concert mastermind cruel summer singer sent several special message nfl star concert buenos aire argentina saturday night	Travis Kelce
taylor swift travis kelce parent reportedly meet upcoming kansa city chief game nfl star parent reportedly set meet pop sensation mom dad team play philadelphia eagle november	Travis Kelce
joe alwyn rock leather look first public appearance since taylor swift travis kelce romance news broke april actor swift started dating called quits relationship reportedly ran course	Travis Kelce
philadelphia radio station forced punt taylor swift song ahead chiefseagles game philadelphia radio station q announced would playing taylor swift song tuesday night	Travis Kelce
joy behar reveals doesnt want taylor swift end travis kelce talk show host let loose stunning opinion travis popstar girlfriend shouldnt together	Travis Kelce
swifties believe taylor swift left another secret message travis kelce concert fan believe taylor swift made yet another subtle nod guy chief argentina concert era tour	Travis Kelce
tiktoker brianna chickenfry think taylor swift travis kelce relationship fake performative bffs podcast cohost questioned way couple behaved pop star era tour show buenos aire argentina	Travis Kelce
taylor swift fan fall love travis kelce even old tweet resurface couple romance continues heat swifties deep diving nfl star like social medium wooed pop star	Travis Kelce
taylor swift travis kelce fan spot pair secret intimate moment date night heart jumped chest upclose video pair walking elena restaurant located four season hotel reveals kelce sweet gesture assurance	Travis Kelce
watch taylor swift travis kelce share kiss buenos aire concert video show singer chief tight end embracing show	Travis Kelce
taylor swift travis kelce make argentina concert dont cry taylor swift argentina amazing show saturday night passionately made man weve seen trace kelce taylor hold hand wrap arm around etc first big	Travis Kelce
swifties agree cant help root taylor swift travis kelce seeing romance unfold real time explains pr expert beth booker think everyone board	Travis Kelce
kelsea ballerini reacts taylor swift travis kelce concert kelsea ballerini rolling welcome mat taylor swift travis kelce pda era fact penthouse singer quite literally applauded taylor running planting kiss	Travis Kelce
hilarie burton predicts taylor swift travis kelce engagement may love story baby hilarie burton think taylor swift may say yes travis kelce seeing kansa city chief player reaction singer sweet karma shoutout	Travis Kelce
taylor swift engaged travis kelce engagement rumor explained taylor swift travis kelce relationship making wave year pair shake singer kansa city chief player inevitably becoming one talkedabout couple celebrity world result many wondering	Travis Kelce
taylor swift travis kelce gave u little kiss week increasingly public appearance taylor swift travis kelce finally gave u little kiss argentina le	Travis Kelce
gigi hadid really feel taylor swift travis kelce romance gigi hadid vigilante mode model recently shut report claimed wasnt fond budding romance close friend taylor swift nfl star travis kelce	Travis Kelce
taylor swift run kiss travis kelce buenos aire concert hard launch taylor swift didnt walkshe ran straight travis kelce arm finishing second era tour show buenos aire nov meeting kansa city chief	Travis Kelce
taylor swift update karma lyric nod travis kelce buenos aire concert ended singer ran arm nfl star gave public smooch	Travis Kelce
fact check joe alwyn furiously reacts taylor swift dating travis kelce video claim video surfaced november accurately reported actor joe alwyn furiously reacted singer taylor swift dating football player travis kelce	Travis Kelce
could taylor swift make kc kelce brother super bowl rematch taylor swift currently touring another continent could make time jet back kansa city travis kelce big game next week breakdown	Travis Kelce
taylor swift embrace travis kelce change song lyric argentina concert taylor swift changed one song lyric reference travis kelce embraced chief tight end opening concert era tour international concert series	Travis Kelce
travis kelce record christmas song brother jason duet taylor swift next travis kelce dating singer taylor swift singer kansa city chief star brother jason recorded christmas duet	Travis Kelce
taylor swifttravis kelce romance get prop chief coach good thing travis kelce coach chief andy reid still getting taylor swift question glad kelce found somebody like ditto taylor	Travis Kelce
taylor swift spotted kissing travis kelce taylor swift travis kelce kissing era tour argentina pictwittercomfqdtajduz pop base popbase november time internet meltdown taylor swift seen kissing travis kelce concert tonight buenos	Travis Kelce
taylor swift travis kelce hallmark movie performance feel sorry travis kelce level top nfl player league best tight end top tight end even say best tight end ever play yet day least masculine thing man act th	Travis Kelce
travis kelce guy chief dish trip argentina taylor swift comin straight home making dad chief fan	Travis Kelce
taylor swift executes halloffame worthy yard dash travis kelce arm let go postgame tape	Travis Kelce
antoni porowski share first public comment friend taylor swift dating travis kelce antoni porowski speaking friend taylor swift new romance travis kelce yearold queer eye star joined yearold superstar kansa chief game last month cheer football star antoni revealing	Travis Kelce
travis kelce reacts taylor swift changing lyric karma reference travis kelce definitely feeling surprised yearold kansa city chief tight end attended girlfriend taylor swift era tour stop buenos aire estadio river plate argentina saturday november changed lyric song	Travis Kelce
hilarie burton predicts taylor swift travis kelce engaged may hilarie burton making big prediction taylor swift travis kelce saturday night november yearold pro football player attended first era tour show yearold blank space singer boyfriend show taylor	Travis Kelce
report travis kelce visit taylor swift argentina amid chief bye week travis kelce reportedly traveling argentina kansa city chief bye week good reason kelce traveling south american	Travis Kelce
travis kelce reportedly travel argentina visit taylor swift travis kelce hinted wednesday byeweek plan might include visit taylor swift speaking brother jason new height podcast kelce said might go somewhere closer equator viewed next report last month wo	Travis Kelce
taylor swift travis kelce draw cheer date buenos aire taylor swift travis kelce love story gone globaland received round applause nov couple reunited buenos aire pop star set perform following day	Travis Kelce
travis kelce plan cheer taylor swift era tour revealed travis kelce cheering taylor swift never go style tight end officially continuing love story south america headed argentina support pop star	Travis Kelce
taylor swift travis kelce reunite argentina swift buenos aire concert canceled due weather tight end dined singer dad	Travis Kelce
tmz travis kelce taylor swift dating overwhelming jason mom donna family kansa city chief tight end travis kelce relationship taylor swift adjustment entire kelce family according tmz sport	Travis Kelce
swiftie halloween costume joked taylor swift put travis kelce map loved get round applause one enjoyed kansa city chief player said watching tiktok one fan made showing clever costume	Travis Kelce
travis kelce reacts costume inspired taylor swift romance travis kelce mad love people done halloween pay homage taylor swift fact kansa city chief tight end brother jason kelce critiqued fan	Travis Kelce
taylor swift travis kelce taste rolexes newlyformed power couple match made horological heaven taylor swift travis kelce penchant iconic rolex daydate	Travis Kelce
getting wrong travis kelce photo illustration erin oflynnthe daily beastgetty image taylor swift boyfriend way guarantee world love much ask frontman swift ex matty healy whose edgelord comment future sw	Travis Kelce
taylor swift give fan another puzzle crack pop star relationship nfl player give fan peculiar form gratification	Travis Kelce
travis kelce open dating taylor swift navigating public scrutiny call girlfriend genius recent interview travis kelce tight end kansa city chief opened difficulty public eye following revelation relationship pop icon taylor swift	Travis Kelce
rafael nadal could cross path taylor swift next year thanks travis kelce kansa city chief tight end travis kelce popstar taylor swift hottest story sport since started dating last month tennis fan joining f	Travis Kelce
travis kelce taylor swift reportedly planning month ahead longterm relationship every single swiftie hoping taylor swift right track travis kelce time popstaraposs previous relationship havenapost fan	Travis Kelce
travis kelce style evolution prof got fashion game look back travis kelce best worst fashion hair overall style look recent date girlfriend taylor swift	Travis Kelce
travis kelce spent thanksgiving without taylor swift swift rumored returning home u holiday seemingly changed mind stayed brazil next era tour show	Travis Kelce
jason kelce wife kylie address rumor feuding taylor swift youre reaching kylie shared video breaking moment said interview attention isnt cup tea	Travis Kelce
travis kelce without taylor swift kansa city chief star celebrate thanksgiving travis kelce spent thanksgiving cruising around kansa city rollsroyce whilst taylor swift brazil quoteras tourquot sao paulo likely bou	Travis Kelce
travis kelce labelled mommy boy fan rediscover footage making dinner request game travis kelce news lot late blossoming relationship taylor swift seen profile grow exponentially even brother jason recognizing	Travis Kelce
packer fan reaction jonathan owen first touchdown married simone bile way cooler dating taylor swift green bay packer surprised many defeating detroit lion thanksgiving showcasing potential future aaron rodgersapos successor quarterback jordan love	Travis Kelce
lonely holiday travis kelce spotted spending thanksgiving without taylor swift singing girlfriend taylor swift mile away brazil travis kelce spotted spending thanksgiving alone singing	Travis Kelce
simone bile celebrates husband jonathan owen first nfl touchdown green bay packer win originally published nov etby george ramsay cnncnn take back seat taylor swift travis kelce another power couple nflolympic champion gymnast simone bile could hardly contain excitement husband jonathan ow	Travis Kelce
thanksgiving guest guide taylor swift travis kelce dont one table behind season hottest romance plot	Travis Kelce
travis kelce driving solo spends thanksgiving away taylor swift travis kelce planning spend christmas taylor swift meantime got ta get another holiday solo mean alone time road kansa city chief star tight end spending thanksgiving	Travis Kelce
kylie kelce responds negative headline taylor swift kylie kelce shutting rumor bad blood taylor swift kylie married jason kelce philadelphia eagle player brother kansa city chief star travis kelce taylor boyfriend kelce family getting	Travis Kelce
kylie kelce fact check taylor swift headline truly iconic tiktok kylie kelce fan account	Travis Kelce
taylor swift travis kelce inner circle thought romance taylor swift travis kelce inner circle havent afraid let opinion pair romance known friend close taylor travis think make amazing power couple couldnt happier source exclusively	Travis Kelce
taylor swift travis kelce heading nashville going romantic getaway theyre trying much like regular couple possible	Travis Kelce
olive garden sends message travis kelce italian restaurant chain joined kelce taylor swift train replying old post kelce called food shmackin	Travis Kelce
nfl bos roger goodell think great taylor swift brings attention league travis kelce romance commissioner said great couple seem enjoying relationship new viewer also bonus	Travis Kelce
travis kelce mom donna share family thanksgiving plan taylor swift remains brazil travis plan feast kfc holiday brother jason kelce invited make quick trip pennsylvania celebrate	Travis Kelce
chris russo go travis kelce visiting taylor swift argentina first take chris russo seems think travis kelce priority wrong place	Travis Kelce
taylor swift still brazil travis kelce mother donna discus family thanksgiving preparation donna kelce share plan thanksgiving whereas travice spending thanksgiving alone taylor swift brazil performance upcoming tour	Travis Kelce
travis kelce traveling see taylor swift tour say travis kelce keeping play close chest kansa city chief player teased plan see taylor swift kick south american leg era tourbut isnt confirming	Travis Kelce
kylie kelce slam headline taylor swift youre reaching kylie kelce posted tiktok address headline avoiding taylor swift spotlight	Travis Kelce
olive garden sends message travis kelce restaurant chain olive garden say making guest feel like family extended family invite kansa city chief tight end travis kelce kelce need eat lot calorie athlete thanks help	Travis Kelce
kylie kelce defends exaggerated quote taylor swift swifties love jason kelceaposs wife kylie kelce opted suite quotmonday night footballquot game philadelphia eagle brotherinlaw travis kelc	Travis Kelce
olympic legend simone bile hype husband jonathan owen packer td v lion taylor swift travis kelce get lot shine arent celebrity couple nfl superstar olympic gymnast simone bile	Travis Kelce
chris russo hit travis kelce trip argentina see taylor swift sport commentator chris russo criticized kansa city chiefsapos tight end travis kelce recent trip argentina see taylor swift perform bye week ru	Travis Kelce
travis kelce accused hiding something relationship taylor swift kansa city chief tight end travis kelce known highprofile relationship taylor swift considered one prominent nfl player season despite bei	Travis Kelce
jason sudeikis weighs taylor swift travis kelce relationship jason sudeikis showing gratitude taylor swiftand travis kelcethis thanksgiving ted lasso star thrilled able catch grammy winner era tour	Travis Kelce
taylor swift fan dug travis kelce old himbo tweet taylor swift romance travis kelce sparked internet investigation swifties discovered nfl star himbo	Travis Kelce
nfl roger goodell travis kelce taylor swift relationship great league nfl commissioner roger goodell happy see taylor swift around league thanks relationship kansa city chief tight end travis kelce	Travis Kelce
nfl commissioner roger goodell call taylor swifttravis kelce romance great league taylor swift good nfl come someone know nfl commissioner roger goodell appeared cbs morning today talk thing football heading thanksgiving weekend subject inevitably turned swift	Travis Kelce
travis kelce reveals thanksgiving taylor swift travis kelce champagne problem hell tolerate thanksgiving without lover kansa city chief player revealed planning spend nov holiday alone missouri	Travis Kelce
jason kelce wife kylie set record straight taylor swift comment jason kelce wife kylie message bottle critic reading much recent comment attention taylor swift travis kelce romance brought family	Travis Kelce
earth taylor swift spending thanksgiving thought nothing left learn taylor swift travis kelce tabloid wildly speculating holiday	Travis Kelce
travis jason kelce thank taylor swift fan reason travis kelce jason kelce know well song became hit brother holiday song fairytale philadelphia scored first spot chart following nov	Travis Kelce
travis kelce confirms taylor swift spending thanksgiving together amid tour singer supposed short break era tour holiday may changed	Travis Kelce
travis kelce hallarious old tweet diary travis kelce described endearing old tweet diary sorted post vault taylor swift diary aka album era	Travis Kelce
nfl commissioner roger goodell open league popularity taylor swift impact cbs morning cohost nate burleson speaks nfl commissioner roger goodell surge league popularity super bowl player safety taylor swift travis kelce much	Travis Kelce
travis kelce reveals thanksgiving plan girlfriend taylor swift brazil jason kelce travis kelce talking thanksgiving kelce brother returned new episode weekly podcast new height jason travis kelce revealed holiday plan podcast two revealed b	Travis Kelce
taylor swift leaning travis kelce following fan tragic death brazil huge support system right	Travis Kelce
ariana madix think taylor swift happy free dating travis kelce ariana madix selfproclaimed taylor swift fan wholeheartedly approves pop star romance travis kelce think seems happy free madix told extra tuesday november asked swift relationship l	Travis Kelce
taylor swift travis kelce love inside holiday plan beginning look lot like fairytale holiday season taylor swift travis kelce couple moving full speed ahead kelce attending swift november concert buenos aire argentina side meeting fam	Travis Kelce
garcia twin say travis kelce throw taylor swift around bedroom nikki garcia brie garcia huge supporter taylor swift travis kelce love nikki told daily mail wednesday november tiktok video finally real man grab throw around br	Travis Kelce
taylor swift fan dug travis kelce old himbo tweet taylor swift boyfriend role fainthearted travis kelce recently discovered pop star ascended onewoman franchise turn tide box office even voting booth gargantuan swarm swifties always r	Travis Kelce
jason travis kelce thank taylor swift fan song jason travis kelce might song together well aware responsible success fairytale philadelphia score yet another win taylor swift legion fan nicknamed swifties wednesday episode	Travis Kelce
jason kelce wife interested spotlight amid taylor swifttravis kelce medium frenzy jason kelce wife kylie looking featured kelcetaylor swift medium frenzy past two month kelce family spotlight since travis began dating swift participating field hockey clinic child	Travis Kelce
jason travis kelce thank taylor swift swifties sending christmas single itunes travis kelce getting taste taylor swift feel like top chart thanks swifties related firsttimers billboard chart week travis kelce jason kelce red clay stray latest ep	Travis Kelce
travis kelce old tweet inspires chipotle change name company even modified sign kansa city chipotle chipotle capitalizing marketing opportunity thanks travis kelce old resurfaced tweet wake pandemonium nfl star budding relationship taylor swift swifties	Travis Kelce
jason travis kelce thank taylor swift fan song jason kelce raised million philadelphia charity debut christmas album last year	Travis Kelce
travis kelce reveals thanksgiving plan taylor swift remains brazil holiday ill feasting kfc wont anybody twotime super bowl champ explained	Travis Kelce
travis jason kelce thank taylor swift swifties getting christmas song new height podcast travis kelce jason thanked taylor swift swift fan	Travis Kelce
taylor swift seemingly staying brazil thanksgiving report swirling taylor swift planning spending thanksgiving new boyfriend travis kelce likely happen year believed taylor spending holiday brazil week amid concer	Travis Kelce
travis jason kelce score first billboard chart hit travis kelce followed girlfriend taylor swift charting first hit billboard chart fairytale philadelphia brother jason kelce	Travis Kelce
jason sudeikis call taylor swift kansa city adopted daughter jason sudeikis grateful taylor swift spending much time hometown kansa city amid romance travis kelce thankful taylor hanging coming two night era tour show sudeikis told h	Travis Kelce
fact check travis kelce responds taylor swift engagement rumor video claim video surfaced november accurately reported travis kelce publicly responded taylor swift engagement rumor	Travis Kelce
travis kelce patrick mahomes saying taylor swift several people close travis kelce expressed thought relationship taylor swift ahead monday chiefseagles tilt	Travis Kelce
taylor swift chief game skipped travis kelce game eagle taylor swift attend kansa city chiefsphiladelphia eagle game november recent development era tour brazil	Travis Kelce
eagle troll chief taylor swift reference big win team posted picture green friendship bracelet read eagle win instagram following victory monday	Travis Kelce
everything taylor swift friend said travis kelce new relationship taylor swift new love story travis kelce lot people talking including lavender haze singer friend taylor dating travis since september since taylor attended several nfl player kansa city chief	Travis Kelce
donna kelce feel bad awkward taylor swift interview apparently still berates handled	Travis Kelce
travis kelce mom regret comment taylor swift travis called today show interview travis kelces mom really regret initial comment taylor swift interview today show early october donna kelce asked thought yearold cruel summer singer meeting first time one	Travis Kelce
travis kelce mom regret way handled taylor swift question donna kelce mother kansa city chief player previously said today meeting pop star ok	Travis Kelce
cara delevingne say taylor swift travis kelce romance different taylor swift love travis kelce glowing dark pal cara delevingne fully supportive budding romance im happy delevingne told e news saturday november la vega grand prix im al	Travis Kelce
taylor swift isnt chief v eagle game tonight taylor initially trying manage going game	Travis Kelce
travis kelce spill mindblowing taylor swift romance gothamgc image kansa city chief tight end travis kelcewho point much america sweetheart new girlfriend taylor swiftserved swifties well monday revealing wall street journal cover story accompanying super	Travis Kelce
taylor swift travis kelce full steam ahead holiday plan talking christmas taylor swift travis kelce looking get christmas spirit couple told theyre moving forward plan together holiday source close couple tell tmz taylor travis trying work	Travis Kelce
travis kelce praise genius taylor swift fing mindblowing travis kelce love taylor swift much deeper look musical talent nfl superstar say fascinated brain learning new thing every day kansa city chief tight end opened relationship	Travis Kelce
travis kelce taylor swift able celebrate thanksgiving together travis kelces girlfriend taylor swift cant make monday night football game tonight november philadelphia eagle unexpected concert perform era tour postponement weekend however fan	Travis Kelce
cara delevingne say taylor swifttravis kelce romance different everything changed since taylor swift started dating travis kelce pop superstar friend cara delevingne belief budding romance kansa city chief tight end	Travis Kelce
taylor swift music temporarily banned philly radio station radio station wont filling blank space taylor swift hit weekend southeast pennsylvania radio station announced pop superstar music temporarily	Travis Kelce
travis kelce reveals love story taylor swift really began travis kelce filling blank space relationship taylor swift kansa city chief tight end grammy winner taken romance public recent month	Travis Kelce
taylor swift wont attendance watch kelce brother chiefseagles taylor swift wont kansa city travis kelce take brother jason monday super bowl lvii rematch	Travis Kelce
travis kelce say never dated anyone like taylor swift im running away travis kelce finally revealing like dating one biggest pop star world taylor swift	Travis Kelce
taylor swift change plan skipping monday chief game singer expected cheer boyfriend travis kelce matchup kansa city chief philadelphia eagle	Travis Kelce
report taylor swift parent dating travis kelce parent nashville tnin latest relationship development fan power couple called adorable source confirmed thursday taylor swift travis kelce parent dating andrea scott donna ed absolutely smitten	Travis Kelce
philly radio station punt swift weekend playlist ahead chiefseagles taylor swift grew eagle fan relationship chief tight end travis kelce causing one philadelphia radio station take chance	Travis Kelce
travis kelce say taylor swift lyric change argentina concert hocked taylor swift referenced travis kelce song embraced chief star era tour international concert series	Travis Kelce
report travis kelce taylor swift parent expected meet eagle v chief travis kelce taylor swift appear taking next step relationship parent chief tight end worldrenowned	Travis Kelce
taylor swift karma stream rise nod travis kelce stream sale midnight hit shot pop star changed lyric referencing kansa city chief boyfriend era tour stop argentina	Travis Kelce
travis kelce mia taylor swift argentina era tour stop jet set like bonnie clyde quite yet travis kelce hinted might joining girlfriend taylor swift argentina era world tour stop swifties	Travis Kelce
